LINHA;T_VIAG;T_GIROS;PAGANTES;GRATUIDADES;DATA;MES;TRANSPORTADOS
LINHA 1;24;199;99;100;01/02/2025;fevereiro;199
LINHA 2;24;34;29;5;01/02/2025;fevereiro;34
LINHA 3;24;58;26;32;01/02/2025;fevereiro;58
LINHA 4;24;19;15;4;01/02/2025;fevereiro;19
LINHA 5;25;17;6;11;01/02/2025;fevereiro;17
LINHA 6;24;126;53;73;01/02/2025;fevereiro;126
LINHA 7;25;18;7;11;01/02/2025;fevereiro;18
LINHA 1;23;61;27;34;02/02/2025;fevereiro;61
LINHA 2;21;6;1;5;02/02/2025;fevereiro;6
LINHA 3;21;29;11;18;02/02/2025;fevereiro;29
LINHA 4;21;9;4;3;02/02/2025;fevereiro;7
LINHA 5;21;13;2;11;02/02/2025;fevereiro;13
LINHA 6;15;34;10;24;02/02/2025;fevereiro;34
LINHA 7;22;2;2;0;02/02/2025;fevereiro;2
LINHA 1;45;419;178;241;03/02/2025;fevereiro;419
LINHA 2;42;109;57;52;03/02/2025;fevereiro;109
LINHA 3;40;231;102;129;03/02/2025;fevereiro;231
LINHA 4;33;41;21;20;03/02/2025;fevereiro;41
LINHA 5;45;66;27;39;03/02/2025;fevereiro;66
LINHA 6;45;244;79;165;03/02/2025;fevereiro;244
LINHA 7;47;16;8;8;03/02/2025;fevereiro;16
LINHA 1;43;396;180;216;04/02/2025;fevereiro;396
LINHA 2;74;120;63;57;04/02/2025;fevereiro;120
LINHA 3;41;191;76;115;04/02/2025;fevereiro;191
LINHA 5;48;36;16;20;04/02/2025;fevereiro;36
LINHA 6;35;244;113;131;04/02/2025;fevereiro;244
LINHA 7;52;15;4;6;04/02/2025;fevereiro;10
LINHA 1;42;36;16;20;05/02/2025;fevereiro;36
LINHA 2;40;73;47;26;05/02/2025;fevereiro;73
LINHA 3;55;241;116;125;05/02/2025;fevereiro;241
LINHA 4;15;26;15;11;05/02/2025;fevereiro;26
LINHA 5;44;36;24;12;05/02/2025;fevereiro;36
LINHA 6;35;257;89;168;05/02/2025;fevereiro;257
LINHA 7;45;11;1;10;05/02/2025;fevereiro;11
LINHA 1;39;405;172;233;06/02/2025;fevereiro;405
LINHA 2;40;86;51;35;06/02/2025;fevereiro;86
LINHA 3;40;184;84;100;06/02/2025;fevereiro;184
LINHA 4;33;36;20;16;06/02/2025;fevereiro;36
LINHA 5;46;51;19;32;06/02/2025;fevereiro;51
LINHA 6;38;296;115;181;06/02/2025;fevereiro;296
LINHA 7;47;17;4;13;06/02/2025;fevereiro;17
LINHA 2;47;88;41;47;07/02/2025;fevereiro;88
LINHA 3;32;224;109;115;07/02/2025;fevereiro;224
LINHA 4;30;66;40;26;07/02/2025;fevereiro;66
LINHA 5;127;57;21;36;07/02/2025;fevereiro;57
LINHA 6;7;15;8;7;07/02/2025;fevereiro;15
LINHA 7;47;23;6;17;07/02/2025;fevereiro;23
LINHA 1;24;222;105;117;08/02/2025;fevereiro;222
LINHA 2;28;37;32;5;08/02/2025;fevereiro;37
LINHA 3;16;45;20;25;08/02/2025;fevereiro;45
LINHA 4;24;18;9;9;08/02/2025;fevereiro;18
LINHA 5;47;24;17;7;08/02/2025;fevereiro;24
LINHA 6;31;95;48;47;08/02/2025;fevereiro;95
LINHA 7;26;8;5;3;08/02/2025;fevereiro;8
LINHA 1;22;79;29;50;09/02/2025;fevereiro;79
LINHA 2;23;14;7;7;09/02/2025;fevereiro;14
LINHA 3;22;50;15;35;09/02/2025;fevereiro;50
LINHA 4;22;14;2;12;09/02/2025;fevereiro;14
LINHA 5;24;14;4;10;09/02/2025;fevereiro;14
LINHA 6;22;50;11;39;09/02/2025;fevereiro;50
LINHA 7;23;4;2;2;09/02/2025;fevereiro;4
LINHA 1;44;452;196;256;10/02/2025;fevereiro;452
LINHA 2;43;91;57;34;10/02/2025;fevereiro;91
LINHA 3;42;224;106;118;10/02/2025;fevereiro;224
LINHA 4;32;38;19;19;10/02/2025;fevereiro;38
LINHA 5;46;65;28;37;10/02/2025;fevereiro;65
LINHA 6;40;336;130;206;10/02/2025;fevereiro;336
LINHA 7;50;16;7;9;10/02/2025;fevereiro;16
LINHA 1;44;401;181;220;11/02/2025;fevereiro;401
LINHA 2;46;86;52;34;11/02/2025;fevereiro;86
LINHA 3;38;203;113;90;11/02/2025;fevereiro;203
LINHA 4;28;57;37;20;11/02/2025;fevereiro;57
LINHA 5;46;56;21;35;11/02/2025;fevereiro;56
LINHA 6;42;257;103;154;11/02/2025;fevereiro;257
LINHA 7;45;18;6;12;11/02/2025;fevereiro;18
LINHA 1;46;391;181;210;12/02/2025;fevereiro;391
LINHA 2;42;82;53;29;12/02/2025;fevereiro;82
LINHA 3;38;223;107;116;12/02/2025;fevereiro;223
LINHA 4;32;49;31;18;12/02/2025;fevereiro;49
LINHA 5;45;67;23;44;12/02/2025;fevereiro;67
LINHA 6;46;244;89;155;12/02/2025;fevereiro;244
LINHA 7;45;7;1;6;12/02/2025;fevereiro;7
LINHA 1;9;0;0;0;13/02/2025;fevereiro;0
LINHA 2;40;77;44;34;13/02/2025;fevereiro;78
LINHA 3;44;199;96;103;13/02/2025;fevereiro;199
LINHA 4;34;49;30;19;13/02/2025;fevereiro;49
LINHA 5;80;51;21;30;13/02/2025;fevereiro;51
LINHA 6;44;259;104;155;13/02/2025;fevereiro;259
LINHA 7;47;13;2;11;13/02/2025;fevereiro;13
LINHA 1;24;170;80;90;14/02/2025;fevereiro;170
LINHA 2;41;90;44;46;14/02/2025;fevereiro;90
LINHA 3;44;206;100;106;14/02/2025;fevereiro;206
LINHA 4;32;56;38;18;14/02/2025;fevereiro;56
LINHA 5;63;46;13;33;14/02/2025;fevereiro;46
LINHA 6;47;252;97;155;14/02/2025;fevereiro;252
LINHA 7;48;18;4;14;14/02/2025;fevereiro;18
LINHA 1;25;228;97;131;15/02/2025;fevereiro;228
LINHA 2;24;37;21;16;15/02/2025;fevereiro;37
LINHA 3;24;78;39;39;15/02/2025;fevereiro;78
LINHA 4;24;22;12;10;15/02/2025;fevereiro;22
LINHA 5;24;27;8;19;15/02/2025;fevereiro;27
LINHA 6;36;116;45;71;15/02/2025;fevereiro;116
LINHA 7;26;17;8;9;15/02/2025;fevereiro;17
LINHA 1;22;74;19;55;16/02/2025;fevereiro;74
LINHA 2;22;17;8;9;16/02/2025;fevereiro;17
LINHA 3;22;34;13;21;16/02/2025;fevereiro;34
LINHA 4;22;9;3;6;16/02/2025;fevereiro;9
LINHA 5;23;13;2;11;16/02/2025;fevereiro;13
LINHA 6;21;34;7;27;16/02/2025;fevereiro;34
LINHA 7;22;0;0;0;16/02/2025;fevereiro;0
LINHA 1;37;318;148;170;17/02/2025;fevereiro;318
LINHA 2;43;77;44;33;17/02/2025;fevereiro;77
LINHA 3;47;214;109;105;17/02/2025;fevereiro;214
LINHA 4;32;46;23;23;17/02/2025;fevereiro;46
LINHA 5;44;68;18;50;17/02/2025;fevereiro;68
LINHA 6;42;239;98;141;17/02/2025;fevereiro;239
LINHA 7;46;15;4;11;17/02/2025;fevereiro;15
LINHA 1;37;366;132;234;18/02/2025;fevereiro;366
LINHA 2;42;96;70;26;18/02/2025;fevereiro;96
LINHA 3;46;196;89;107;18/02/2025;fevereiro;196
LINHA 4;34;47;28;19;18/02/2025;fevereiro;47
LINHA 5;46;57;14;43;18/02/2025;fevereiro;57
LINHA 6;37;214;79;135;18/02/2025;fevereiro;214
LINHA 7;46;11;4;7;18/02/2025;fevereiro;11
LINHA 1;33;306;113;193;19/02/2025;fevereiro;306
LINHA 2;38;84;42;42;19/02/2025;fevereiro;84
LINHA 3;44;216;103;113;19/02/2025;fevereiro;216
LINHA 4;39;72;43;29;19/02/2025;fevereiro;72
LINHA 5;46;48;17;31;19/02/2025;fevereiro;48
LINHA 6;41;233;94;139;19/02/2025;fevereiro;233
LINHA 7;46;18;6;12;19/02/2025;fevereiro;18
LINHA 1;38;336;145;191;20/02/2025;fevereiro;336
LINHA 2;39;66;47;19;20/02/2025;fevereiro;66
LINHA 3;44;229;118;111;20/02/2025;fevereiro;229
LINHA 4;34;41;24;17;20/02/2025;fevereiro;41
LINHA 5;20;20;8;12;20/02/2025;fevereiro;20
LINHA 6;44;235;82;153;20/02/2025;fevereiro;235
LINHA 7;72;42;7;35;20/02/2025;fevereiro;42
LINHA 1;32;341;134;207;21/02/2025;fevereiro;341
LINHA 2;41;84;50;34;21/02/2025;fevereiro;84
LINHA 3;45;198;116;82;21/02/2025;fevereiro;198
LINHA 4;36;54;32;22;21/02/2025;fevereiro;54
LINHA 5;46;53;22;31;21/02/2025;fevereiro;53
LINHA 6;45;263;104;159;21/02/2025;fevereiro;263
LINHA 7;46;18;3;15;21/02/2025;fevereiro;18
LINHA 1;24;178;77;101;22/02/2025;fevereiro;178
LINHA 2;24;39;23;16;22/02/2025;fevereiro;39
LINHA 3;24;82;45;37;22/02/2025;fevereiro;82
LINHA 4;24;27;18;9;22/02/2025;fevereiro;27
LINHA 5;26;41;18;23;22/02/2025;fevereiro;41
LINHA 6;40;161;73;88;22/02/2025;fevereiro;161
LINHA 7;20;13;2;11;22/02/2025;fevereiro;13
LINHA 1;22;71;61;10;23/02/2025;fevereiro;71
LINHA 2;24;6;4;2;23/02/2025;fevereiro;6
LINHA 3;22;49;36;13;23/02/2025;fevereiro;49
LINHA 4;22;21;13;8;23/02/2025;fevereiro;21
LINHA 5;26;14;12;2;23/02/2025;fevereiro;14
LINHA 6;22;42;28;14;23/02/2025;fevereiro;42
LINHA 7;22;1;0;1;23/02/2025;fevereiro;1
LINHA 1;37;350;131;219;24/02/2025;fevereiro;350
LINHA 2;40;115;76;39;24/02/2025;fevereiro;115
LINHA 3;45;203;119;84;24/02/2025;fevereiro;203
LINHA 4;33;51;25;26;24/02/2025;fevereiro;51
LINHA 5;46;51;19;32;24/02/2025;fevereiro;51
LINHA 6;38;225;87;138;24/02/2025;fevereiro;225
LINHA 7;47;12;5;7;24/02/2025;fevereiro;12
LINHA 1;36;406;161;245;25/02/2025;fevereiro;406
LINHA 2;42;117;66;51;25/02/2025;fevereiro;117
LINHA 3;44;232;123;109;25/02/2025;fevereiro;232
LINHA 4;32;59;34;25;25/02/2025;fevereiro;59
LINHA 5;50;47;18;29;25/02/2025;fevereiro;47
LINHA 6;44;267;89;178;25/02/2025;fevereiro;267
LINHA 7;36;18;9;9;25/02/2025;fevereiro;18
LINHA 1;40;329;141;188;26/02/2025;fevereiro;329
LINHA 2;44;79;56;23;26/02/2025;fevereiro;79
LINHA 3;46;213;112;101;26/02/2025;fevereiro;213
LINHA 4;32;75;46;29;26/02/2025;fevereiro;75
LINHA 5;46;49;21;28;26/02/2025;fevereiro;49
LINHA 6;48;264;108;156;26/02/2025;fevereiro;264
LINHA 7;8;0;0;0;26/02/2025;fevereiro;0
LINHA 1;45;385;164;221;27/02/2025;fevereiro;385
LINHA 2;43;88;56;32;27/02/2025;fevereiro;88
LINHA 3;46;229;120;109;27/02/2025;fevereiro;229
LINHA 4;28;52;29;23;27/02/2025;fevereiro;52
LINHA 5;46;56;21;35;27/02/2025;fevereiro;56
LINHA 6;45;230;89;141;27/02/2025;fevereiro;230
LINHA 7;47;15;3;12;27/02/2025;fevereiro;15
LINHA 1;41;480;193;287;28/02/2025;fevereiro;480
LINHA 2;56;257;136;121;28/02/2025;fevereiro;257
LINHA 3;30;78;33;45;28/02/2025;fevereiro;78
LINHA 4;28;60;31;29;28/02/2025;fevereiro;60
LINHA 5;45;66;26;40;28/02/2025;fevereiro;66
LINHA 6;46;293;112;181;28/02/2025;fevereiro;293
LINHA 7;50;10;5;5;28/02/2025;fevereiro;10
CIRCULAR - 01;;;52;0;12/08/2024;agosto;52
LINHA 1;;;29;0;12/08/2024;agosto;29
LINHA 6;;;7;0;12/08/2024;agosto;7
LINHA 6;;;24;0;12/08/2024;agosto;24
CIRCULAR - 01;;;42;0;12/08/2024;agosto;42
LINHA 1;;;5;0;12/08/2024;agosto;5
CIRCULAR - 01;;;29;0;12/08/2024;agosto;29
LINHA 6;;;17;0;12/08/2024;agosto;17
LINHA 1;;;2;0;13/08/2024;agosto;2
LINHA 1;;;25;0;13/08/2024;agosto;25
LINHA 6;;;8;0;13/08/2024;agosto;8
CIRCULAR - 01;;;38;0;13/08/2024;agosto;38
CIRCULAR - 01;;;2;0;13/08/2024;agosto;2
CIRCULAR - 01;;;41;0;13/08/2024;agosto;41
LINHA 6;;;27;0;13/08/2024;agosto;27
LINHA 6;;;28;0;13/08/2024;agosto;28
LINHA 1;;;44;0;13/08/2024;agosto;44
CIRCULAR - 01;;;23;0;13/08/2024;agosto;23
CIRCULAR - 01;;;2;0;13/08/2024;agosto;2
CIRCULAR - 01;;;117;0;14/08/2024;agosto;117
CIRCULAR - 01;;;41;0;14/08/2024;agosto;41
CIRCULAR - 01;;;26;0;14/08/2024;agosto;26
CIRCULAR - 01;;;89;0;15/08/2024;agosto;89
CIRCULAR - 01;;;39;0;15/08/2024;agosto;39
CIRCULAR - 01;;;33;0;15/08/2024;agosto;33
LINHA 6;;;7;0;15/08/2024;agosto;7
LINHA 6;;;17;0;15/08/2024;agosto;17
LINHA 6;;;10;0;15/08/2024;agosto;10
LINHA 6;;;12;0;16/08/2024;agosto;12
LINHA 6;;;33;0;16/08/2024;agosto;33
LINHA 6;;;12;0;16/08/2024;agosto;12
CIRCULAR - 01;;;64;0;16/08/2024;agosto;64
CIRCULAR - 01;;;36;0;16/08/2024;agosto;36
CIRCULAR - 01;;;23;0;16/08/2024;agosto;23
LINHA 1;;;23;0;16/08/2024;agosto;23
LINHA 1;;;50;0;16/08/2024;agosto;50
LINHA 6;;;38;0;17/08/2024;agosto;38
LINHA 6;;;11;0;17/08/2024;agosto;11
CIRCULAR - 01;;;48;0;17/08/2024;agosto;48
CIRCULAR - 01;;;15;0;17/08/2024;agosto;15
CIRCULAR - 01;;;12;0;17/08/2024;agosto;12
LINHA 1;;;49;0;17/08/2024;agosto;49
LINHA 1;;;24;0;17/08/2024;agosto;24
LINHA 6;;;10;0;18/08/2024;agosto;10
LINHA 6;;;5;0;18/08/2024;agosto;5
CIRCULAR - 01;;;28;0;18/08/2024;agosto;28
CIRCULAR - 01;;;13;0;18/08/2024;agosto;13
CIRCULAR - 01;;;19;0;18/08/2024;agosto;19
LINHA 1;;;5;0;18/08/2024;agosto;5
LINHA 1;;;2;0;18/08/2024;agosto;2
LINHA 1;;;38;0;19/08/2024;agosto;38
LINHA 1;;;51;0;19/08/2024;agosto;51
CIRCULAR - 01;;;56;0;19/08/2024;agosto;56
CIRCULAR - 01;;;37;0;19/08/2024;agosto;37
CIRCULAR - 01;;;16;0;19/08/2024;agosto;16
LINHA 6;;;11;0;19/08/2024;agosto;11
LINHA 6;;;38;0;19/08/2024;agosto;38
LINHA 6;;;32;0;19/08/2024;agosto;32
LINHA 1;;;32;0;20/08/2024;agosto;32
LINHA 1;;;85;0;20/08/2024;agosto;85
CIRCULAR - 01;;;77;0;20/08/2024;agosto;77
CIRCULAR - 01;;;38;0;20/08/2024;agosto;38
CIRCULAR - 01;;;29;0;20/08/2024;agosto;29
LINHA 6;;;11;0;20/08/2024;agosto;11
LINHA 6;;;26;0;20/08/2024;agosto;26
LINHA 6;;;22;0;20/08/2024;agosto;22
LINHA 1;;;47;0;21/08/2024;agosto;47
LINHA 1;;;61;0;21/08/2024;agosto;61
CIRCULAR - 01;;;84;0;21/08/2024;agosto;84
CIRCULAR - 01;;;32;0;21/08/2024;agosto;32
CIRCULAR - 01;;;23;0;21/08/2024;agosto;23
LINHA 6;;;14;0;21/08/2024;agosto;14
LINHA 6;;;46;0;21/08/2024;agosto;46
LINHA 6;;;31;0;21/08/2024;agosto;31
LINHA 1;;;29;0;22/08/2024;agosto;29
LINHA 1;;;74;0;22/08/2024;agosto;74
CIRCULAR - 01;;;69;0;22/08/2024;agosto;69
CIRCULAR - 01;;;37;0;22/08/2024;agosto;37
CIRCULAR - 01;;;20;0;22/08/2024;agosto;20
LINHA 6;;;12;0;22/08/2024;agosto;12
LINHA 6;;;29;0;22/08/2024;agosto;29
LINHA 6;;;25;0;22/08/2024;agosto;25
LINHA 1;;;26;0;23/08/2024;agosto;26
LINHA 1;;;62;0;23/08/2024;agosto;62
CIRCULAR - 01;;;50;0;23/08/2024;agosto;50
CIRCULAR - 01;;;72;0;23/08/2024;agosto;72
CIRCULAR - 01;;;18;0;23/08/2024;agosto;18
LINHA 6;;;9;0;23/08/2024;agosto;9
LINHA 6;;;34;0;23/08/2024;agosto;34
LINHA 6;;;27;0;23/08/2024;agosto;27
LINHA 1;;;48;0;24/08/2024;agosto;48
LINHA 1;;;31;0;24/08/2024;agosto;31
CIRCULAR - 01;;;47;0;24/08/2024;agosto;47
CIRCULAR - 01;;;21;0;24/08/2024;agosto;21
CIRCULAR - 01;;;16;0;24/08/2024;agosto;16
LINHA 6;;;28;0;24/08/2024;agosto;28
LINHA 6;;;26;0;24/08/2024;agosto;26
LINHA 1;;;18;0;25/08/2024;agosto;18
LINHA 1;;;13;0;25/08/2024;agosto;13
CIRCULAR - 01;;;16;0;25/08/2024;agosto;16
CIRCULAR - 01;;;3;0;25/08/2024;agosto;3
CIRCULAR - 01;;;9;0;25/08/2024;agosto;9
LINHA 6;;;11;0;25/08/2024;agosto;11
LINHA 6;;;7;0;25/08/2024;agosto;7
LINHA 1;;;40;0;26/08/2024;agosto;40
LINHA 1;;;35;0;26/08/2024;agosto;35
LINHA 6;;;14;0;26/08/2024;agosto;14
LINHA 6;;;40;0;26/08/2024;agosto;40
LINHA 6;;;28;0;26/08/2024;agosto;28
CIRCULAR - 01;;;56;0;26/08/2024;agosto;56
CIRCULAR - 01;;;45;0;26/08/2024;agosto;45
CIRCULAR - 01;;;21;0;26/08/2024;agosto;21
LINHA 1;;;17;0;27/08/2024;agosto;17
LINHA 1;;;85;0;27/08/2024;agosto;85
LINHA 6;;;0;0;27/08/2024;agosto;0
LINHA 6;;;48;0;27/08/2024;agosto;48
LINHA 6;;;28;0;27/08/2024;agosto;28
CIRCULAR - 01;;;94;0;27/08/2024;agosto;94
CIRCULAR - 01;;;28;0;27/08/2024;agosto;28
CIRCULAR - 01;;;18;0;27/08/2024;agosto;18
LINHA 1;;;39;0;28/08/2024;agosto;39
LINHA 1;;;83;0;28/08/2024;agosto;83
CIRCULAR - 01;;;62;0;28/08/2024;agosto;62
CIRCULAR - 01;;;30;0;28/08/2024;agosto;30
CIRCULAR - 01;;;7;0;28/08/2024;agosto;7
LINHA 6;;;16;0;28/08/2024;agosto;16
LINHA 6;;;38;0;28/08/2024;agosto;38
LINHA 6;;;20;0;28/08/2024;agosto;20
LINHA 6;;;10;0;28/08/2024;agosto;10
LINHA 1;;;46;0;29/08/2024;agosto;46
LINHA 1;;;75;0;29/08/2024;agosto;75
LINHA 6;;;27;0;29/08/2024;agosto;27
LINHA 6;;;43;0;29/08/2024;agosto;43
LINHA 6;;;21;0;29/08/2024;agosto;21
CIRCULAR - 01;;;78;0;29/08/2024;agosto;78
CIRCULAR - 01;;;27;0;29/08/2024;agosto;27
CIRCULAR - 01;;;19;0;29/08/2024;agosto;19
LINHA 1;;;55;0;30/08/2024;agosto;55
LINHA 1;;;69;0;30/08/2024;agosto;69
LINHA 6;;;22;0;30/08/2024;agosto;22
LINHA 6;;;48;0;30/08/2024;agosto;48
LINHA 6;;;19;0;30/08/2024;agosto;19
CIRCULAR - 01;;;66;0;30/08/2024;agosto;66
CIRCULAR - 01;;;20;0;30/08/2024;agosto;20
CIRCULAR - 01;;;25;0;30/08/2024;agosto;25
CIRCULAR - 01;;;0;0;30/08/2024;agosto;0
LINHA 1;;;59;0;31/08/2024;agosto;59
LINHA 1;;;31;0;31/08/2024;agosto;31
LINHA 6;;;49;0;31/08/2024;agosto;49
LINHA 6;;;13;0;31/08/2024;agosto;13
CIRCULAR - 01;;;69;0;31/08/2024;agosto;69
CIRCULAR - 01;;;17;0;31/08/2024;agosto;17
CIRCULAR - 01;;;11;0;31/08/2024;agosto;11
LINHA 1;;;10;0;01/09/2024;setembro;10
LINHA 1;;;15;0;01/09/2024;setembro;15
LINHA 6;;;9;0;01/09/2024;setembro;9
LINHA 6;;;12;0;01/09/2024;setembro;12
CIRCULAR - 01;;;52;0;01/09/2024;setembro;52
CIRCULAR - 01;;;6;0;01/09/2024;setembro;6
CIRCULAR - 01;;;19;0;01/09/2024;setembro;19
LINHA 1;;;52;0;02/09/2024;setembro;52
LINHA 1;;;59;0;02/09/2024;setembro;59
LINHA 6;;;18;0;02/09/2024;setembro;18
LINHA 6;;;40;0;02/09/2024;setembro;40
LINHA 6;;;29;0;02/09/2024;setembro;29
LINHA 3;;;16;0;02/09/2024;setembro;16
LINHA 3;;;23;0;02/09/2024;setembro;23
CIRCULAR - 01;;;78;0;02/09/2024;setembro;78
CIRCULAR - 01;;;28;0;02/09/2024;setembro;28
CIRCULAR - 01;;;29;0;02/09/2024;setembro;29
LINHA 1;;;48;0;03/09/2024;setembro;48
LINHA 1;;;83;0;03/09/2024;setembro;83
LINHA 6;;;12;0;03/09/2024;setembro;12
LINHA 6;;;8;0;03/09/2024;setembro;8
LINHA 6;;;22;0;03/09/2024;setembro;22
LINHA 6;;;17;0;03/09/2024;setembro;17
LINHA 3;;;37;0;03/09/2024;setembro;37
LINHA 3;;;13;0;03/09/2024;setembro;13
CIRCULAR - 01;;;69;0;03/09/2024;setembro;69
CIRCULAR - 01;;;41;0;03/09/2024;setembro;41
CIRCULAR - 01;;;29;0;03/09/2024;setembro;29
LINHA 1;;;45;0;04/09/2024;setembro;45
LINHA 1;;;102;0;04/09/2024;setembro;102
LINHA 6;;;13;0;04/09/2024;setembro;13
LINHA 6;;;33;0;04/09/2024;setembro;33
LINHA 6;;;32;0;04/09/2024;setembro;32
LINHA 3;;;26;0;04/09/2024;setembro;26
LINHA 3;;;15;0;04/09/2024;setembro;15
CIRCULAR - 01;;;78;0;04/09/2024;setembro;78
CIRCULAR - 01;;;25;0;04/09/2024;setembro;25
CIRCULAR - 01;;;29;0;04/09/2024;setembro;29
LINHA 3;;;27;0;05/09/2024;setembro;27
LINHA 3;;;17;0;05/09/2024;setembro;17
LINHA 1;;;56;0;05/09/2024;setembro;56
LINHA 1;;;95;0;05/09/2024;setembro;95
LINHA 6;;;19;0;05/09/2024;setembro;19
LINHA 6;;;50;0;05/09/2024;setembro;50
LINHA 6;;;19;0;05/09/2024;setembro;19
CIRCULAR - 01;;;66;0;05/09/2024;setembro;66
CIRCULAR - 01;;;31;0;05/09/2024;setembro;31
CIRCULAR - 01;;;21;0;05/09/2024;setembro;21
LINHA 3;;;47;0;06/09/2024;setembro;47
LINHA 3;;;30;0;06/09/2024;setembro;30
CIRCULAR - 01;;;33;0;06/09/2024;setembro;33
LINHA 6;;;30;0;06/09/2024;setembro;30
LINHA 6;;;42;0;06/09/2024;setembro;42
LINHA 6;;;30;0;06/09/2024;setembro;30
CIRCULAR - 01;;;90;0;06/09/2024;setembro;90
LINHA 1;;;61;0;06/09/2024;setembro;61
LINHA 1;;;102;0;06/09/2024;setembro;102
LINHA 3;;;5;0;07/09/2024;setembro;5
LINHA 3;;;24;0;07/09/2024;setembro;24
LINHA 6;;;15;0;07/09/2024;setembro;15
LINHA 6;;;22;0;07/09/2024;setembro;22
LINHA 1;;;26;0;07/09/2024;setembro;26
LINHA 1;;;20;0;07/09/2024;setembro;20
CIRCULAR - 01;;;33;0;07/09/2024;setembro;33
CIRCULAR - 01;;;11;0;07/09/2024;setembro;11
CIRCULAR - 01;;;15;0;07/09/2024;setembro;15
LINHA 3;;;0;0;08/09/2024;setembro;0
LINHA 3;;;14;0;08/09/2024;setembro;14
LINHA 1;;;7;0;08/09/2024;setembro;7
LINHA 1;;;9;0;08/09/2024;setembro;9
LINHA 6;;;8;0;08/09/2024;setembro;8
LINHA 6;;;8;0;08/09/2024;setembro;8
CIRCULAR - 01;;;35;0;08/09/2024;setembro;35
CIRCULAR - 01;;;5;0;08/09/2024;setembro;5
CIRCULAR - 01;;;16;0;08/09/2024;setembro;16
LINHA 3;;;26;0;09/09/2024;setembro;26
LINHA 3;;;32;0;09/09/2024;setembro;32
LINHA 6;;;17;0;09/09/2024;setembro;17
LINHA 6;;;55;0;09/09/2024;setembro;55
LINHA 6;;;21;0;09/09/2024;setembro;21
LINHA 1;;;51;0;09/09/2024;setembro;51
LINHA 1;;;69;0;09/09/2024;setembro;69
CIRCULAR - 01;;;76;0;09/09/2024;setembro;76
CIRCULAR - 01;;;32;0;09/09/2024;setembro;32
CIRCULAR - 01;;;31;0;09/09/2024;setembro;31
CIRCULAR - 01;;;15;0;10/09/2024;setembro;15
CIRCULAR - 01;;;39;0;10/09/2024;setembro;39
CIRCULAR - 01;;;21;0;10/09/2024;setembro;21
LINHA 6;;;20;0;10/09/2024;setembro;20
LINHA 6;;;40;0;10/09/2024;setembro;40
LINHA 6;;;24;0;10/09/2024;setembro;24
LINHA 3;;;40;0;10/09/2024;setembro;40
LINHA 3;;;32;0;10/09/2024;setembro;32
LINHA 1;;;53;0;10/09/2024;setembro;53
LINHA 1;;;79;0;10/09/2024;setembro;79
CIRCULAR - 01;;;30;0;10/09/2024;setembro;30
LINHA 1;;;60;0;11/09/2024;setembro;60
LINHA 1;;;78;0;11/09/2024;setembro;78
LINHA 6;;;8;0;11/09/2024;setembro;8
CIRCULAR - 01;;;24;0;11/09/2024;setembro;24
CIRCULAR - 01;;;55;0;11/09/2024;setembro;55
CIRCULAR - 01;;;26;0;11/09/2024;setembro;26
CIRCULAR - 01;;;6;0;11/09/2024;setembro;6
LINHA 6;;;34;0;11/09/2024;setembro;34
LINHA 6;;;21;0;11/09/2024;setembro;21
LINHA 3;;;37;0;11/09/2024;setembro;37
LINHA 3;;;29;0;11/09/2024;setembro;29
LINHA 3;;;11;0;12/09/2024;setembro;11
CIRCULAR - 01;;;44;0;12/09/2024;setembro;44
CIRCULAR - 01;;;31;0;12/09/2024;setembro;31
CIRCULAR - 01;;;12;0;12/09/2024;setembro;12
LINHA 6;;;21;0;12/09/2024;setembro;21
LINHA 6;;;26;0;12/09/2024;setembro;26
LINHA 6;;;22;0;12/09/2024;setembro;22
CIRCULAR - 01;;;20;0;12/09/2024;setembro;20
LINHA 3;;;29;0;12/09/2024;setembro;29
LINHA 3;;;34;0;12/09/2024;setembro;34
LINHA 1;;;70;0;12/09/2024;setembro;70
LINHA 1;;;74;0;12/09/2024;setembro;74
LINHA 3;;;33;0;13/09/2024;setembro;33
LINHA 3;;;36;0;13/09/2024;setembro;36
LINHA 6;;;15;0;13/09/2024;setembro;15
LINHA 6;;;61;0;13/09/2024;setembro;61
LINHA 6;;;32;0;13/09/2024;setembro;32
CIRCULAR - 01;;;57;0;13/09/2024;setembro;57
CIRCULAR - 01;;;18;0;13/09/2024;setembro;18
CIRCULAR - 01;;;13;0;13/09/2024;setembro;13
LINHA 1;;;61;0;13/09/2024;setembro;61
LINHA 1;;;79;0;13/09/2024;setembro;79
LINHA 3;;;13;0;14/09/2024;setembro;13
LINHA 3;;;26;0;14/09/2024;setembro;26
LINHA 6;;;32;0;14/09/2024;setembro;32
LINHA 6;;;12;0;14/09/2024;setembro;12
CIRCULAR - 01;;;39;0;14/09/2024;setembro;39
CIRCULAR - 01;;;18;0;14/09/2024;setembro;18
CIRCULAR - 01;;;15;0;14/09/2024;setembro;15
LINHA 1;;;41;0;14/09/2024;setembro;41
LINHA 1;;;19;0;14/09/2024;setembro;19
LINHA 1;;;26;0;15/09/2024;setembro;26
LINHA 6;;;14;0;15/09/2024;setembro;14
LINHA 6;;;8;0;15/09/2024;setembro;8
LINHA 3;;;1;0;15/09/2024;setembro;1
LINHA 3;;;9;0;15/09/2024;setembro;9
CIRCULAR - 01;;;20;0;15/09/2024;setembro;20
CIRCULAR - 01;;;14;0;15/09/2024;setembro;14
LINHA 3;;;4;0;15/09/2024;setembro;4
LINHA 3;;;32;0;16/09/2024;setembro;32
LINHA 3;;;29;0;16/09/2024;setembro;29
LINHA 6;;;21;0;16/09/2024;setembro;21
LINHA 6;;;54;0;16/09/2024;setembro;54
LINHA 6;;;20;0;16/09/2024;setembro;20
CIRCULAR - 01;;;58;0;16/09/2024;setembro;58
CIRCULAR - 01;;;34;0;16/09/2024;setembro;34
CIRCULAR - 01;;;18;0;16/09/2024;setembro;18
LINHA 1;;;52;0;16/09/2024;setembro;52
LINHA 1;;;71;0;16/09/2024;setembro;71
CIRCULAR - 01;;;74;0;17/09/2024;setembro;74
CIRCULAR - 01;;;18;0;17/09/2024;setembro;18
LINHA 3;;;34;0;17/09/2024;setembro;34
LINHA 3;;;18;0;17/09/2024;setembro;18
LINHA 1;;;48;0;17/09/2024;setembro;48
LINHA 1;;;128;0;17/09/2024;setembro;128
LINHA 3;;;39;0;18/09/2024;setembro;39
LINHA 6;;;31;0;18/09/2024;setembro;31
LINHA 6;;;41;0;18/09/2024;setembro;41
CIRCULAR - 01;;;66;0;18/09/2024;setembro;66
CIRCULAR - 01;;;29;0;18/09/2024;setembro;29
LINHA 1;;;54;0;18/09/2024;setembro;54
LINHA 1;;;76;0;18/09/2024;setembro;76
LINHA 6;;;26;0;19/09/2024;setembro;26
LINHA 6;;;32;0;19/09/2024;setembro;32
CIRCULAR - 01;;;60;0;19/09/2024;setembro;60
CIRCULAR - 01;;;32;0;19/09/2024;setembro;32
CIRCULAR - 01;;;2;0;19/09/2024;setembro;2
LINHA 1;;;53;0;19/09/2024;setembro;53
LINHA 1;;;89;0;19/09/2024;setembro;89
LINHA 3;;;28;0;19/09/2024;setembro;28
LINHA 3;;;23;0;19/09/2024;setembro;23
LINHA 6;;;38;0;20/09/2024;setembro;38
LINHA 6;;;26;0;20/09/2024;setembro;26
LINHA 3;;;3;0;20/09/2024;setembro;3
LINHA 3;;;24;0;20/09/2024;setembro;24
CIRCULAR - 01;;;67;0;20/09/2024;setembro;67
CIRCULAR - 01;;;34;0;20/09/2024;setembro;34
CIRCULAR - 01;;;8;0;20/09/2024;setembro;8
LINHA 1;;;44;0;20/09/2024;setembro;44
LINHA 1;;;84;0;20/09/2024;setembro;84
LINHA 3;;;22;0;20/09/2024;setembro;22
LINHA 1;;;56;0;21/09/2024;setembro;56
LINHA 1;;;51;0;21/09/2024;setembro;51
LINHA 6;;;44;0;21/09/2024;setembro;44
LINHA 6;;;21;0;21/09/2024;setembro;21
LINHA 3;;;18;0;21/09/2024;setembro;18
LINHA 3;;;24;0;21/09/2024;setembro;24
CIRCULAR - 01;;;31;0;21/09/2024;setembro;31
CIRCULAR - 01;;;14;0;21/09/2024;setembro;14
CIRCULAR - 01;;;21;0;21/09/2024;setembro;21
LINHA 1;;;40;0;22/09/2024;setembro;40
LINHA 6;;;13;0;22/09/2024;setembro;13
CIRCULAR - 01;;;22;0;22/09/2024;setembro;22
CIRCULAR - 01;;;9;0;22/09/2024;setembro;9
CIRCULAR - 01;;;34;0;22/09/2024;setembro;34
LINHA 3;;;4;0;22/09/2024;setembro;4
LINHA 3;;;11;0;22/09/2024;setembro;11
LINHA 1;;;38;0;23/09/2024;setembro;38
LINHA 1;;;20;0;23/09/2024;setembro;20
CIRCULAR - 01;;;27;0;23/09/2024;setembro;27
CIRCULAR - 01;;;20;0;23/09/2024;setembro;20
LINHA 6;;;21;0;23/09/2024;setembro;21
LINHA 6;;;34;0;23/09/2024;setembro;34
LINHA 3;;;23;0;23/09/2024;setembro;23
LINHA 3;;;15;0;23/09/2024;setembro;15
LINHA 3;;;42;0;24/09/2024;setembro;42
LINHA 3;;;32;0;24/09/2024;setembro;32
LINHA 1;;;74;0;24/09/2024;setembro;74
LINHA 1;;;81;0;24/09/2024;setembro;81
LINHA 6;;;50;0;24/09/2024;setembro;50
LINHA 6;;;57;0;24/09/2024;setembro;57
CIRCULAR - 01;;;65;0;24/09/2024;setembro;65
CIRCULAR - 01;;;27;0;24/09/2024;setembro;27
LINHA 3;;;28;0;25/09/2024;setembro;28
LINHA 3;;;34;0;25/09/2024;setembro;34
LINHA 1;;;54;0;25/09/2024;setembro;54
LINHA 1;;;52;0;25/09/2024;setembro;52
CIRCULAR - 01;;;68;0;25/09/2024;setembro;68
CIRCULAR - 01;;;31;0;25/09/2024;setembro;31
LINHA 6;;;29;0;25/09/2024;setembro;29
LINHA 6;;;37;0;25/09/2024;setembro;37
LINHA 3;;;34;0;26/09/2024;setembro;34
LINHA 3;;;26;0;26/09/2024;setembro;26
LINHA 1;;;58;0;26/09/2024;setembro;58
LINHA 1;;;58;0;26/09/2024;setembro;58
LINHA 6;;;3;0;26/09/2024;setembro;3
CIRCULAR - 01;;;68;0;26/09/2024;setembro;68
CIRCULAR - 01;;;21;0;26/09/2024;setembro;21
LINHA 6;;;35;0;26/09/2024;setembro;35
LINHA 6;;;26;0;26/09/2024;setembro;26
LINHA 6;;;63;0;27/09/2024;setembro;63
LINHA 6;;;17;0;27/09/2024;setembro;17
LINHA 3;;;38;0;27/09/2024;setembro;38
LINHA 3;;;19;0;27/09/2024;setembro;19
LINHA 1;;;67;0;27/09/2024;setembro;67
LINHA 1;;;90;0;27/09/2024;setembro;90
CIRCULAR - 01;;;80;0;27/09/2024;setembro;80
CIRCULAR - 01;;;44;0;27/09/2024;setembro;44
LINHA 6;;;25;0;27/09/2024;setembro;25
LINHA 3;;;17;0;28/09/2024;setembro;17
LINHA 1;;;53;0;28/09/2024;setembro;53
LINHA 1;;;23;0;28/09/2024;setembro;23
LINHA 6;;;29;0;28/09/2024;setembro;29
LINHA 6;;;9;0;28/09/2024;setembro;9
CIRCULAR - 01;;;42;0;28/09/2024;setembro;42
CIRCULAR - 01;;;18;0;28/09/2024;setembro;18
LINHA 1;;;4;0;29/09/2024;setembro;4
LINHA 1;;;15;0;29/09/2024;setembro;15
LINHA 3;;;0;0;29/09/2024;setembro;0
LINHA 3;;;7;0;29/09/2024;setembro;7
LINHA 1;;;2;0;29/09/2024;setembro;2
LINHA 6;;;9;0;29/09/2024;setembro;9
LINHA 6;;;8;0;29/09/2024;setembro;8
CIRCULAR - 01;;;16;0;29/09/2024;setembro;16
CIRCULAR - 01;;;7;0;29/09/2024;setembro;7
CIRCULAR - 01;;;3;0;29/09/2024;setembro;3
LINHA 1;;;66;0;30/09/2024;setembro;66
LINHA 1;;;74;0;30/09/2024;setembro;74
LINHA 3;;;38;0;30/09/2024;setembro;38
LINHA 3;;;21;0;30/09/2024;setembro;21
LINHA 6;;;65;0;30/09/2024;setembro;65
LINHA 6;;;49;0;30/09/2024;setembro;49
CIRCULAR - 01;;;75;0;30/09/2024;setembro;75
CIRCULAR - 01;;;19;0;30/09/2024;setembro;19
LINHA 3;;;35;0;01/10/2024;outubro;35
LINHA 3;;;32;0;01/10/2024;outubro;32
LINHA 1;;;66;0;01/10/2024;outubro;66
LINHA 1;;;71;0;01/10/2024;outubro;71
LINHA 6;;;44;0;01/10/2024;outubro;44
LINHA 6;;;48;0;01/10/2024;outubro;48
CIRCULAR - 01;;;72;0;01/10/2024;outubro;72
CIRCULAR - 01;;;40;0;01/10/2024;outubro;40
LINHA 3;;;30;0;02/10/2024;outubro;30
LINHA 3;;;29;0;02/10/2024;outubro;29
LINHA 1;;;47;0;02/10/2024;outubro;47
LINHA 1;;;72;0;02/10/2024;outubro;72
CIRCULAR - 01;;;69;0;02/10/2024;outubro;69
CIRCULAR - 01;;;22;0;02/10/2024;outubro;22
CIRCULAR - 01;;;16;0;02/10/2024;outubro;16
LINHA 6;;;23;0;02/10/2024;outubro;23
LINHA 6;;;39;0;02/10/2024;outubro;39
LINHA 6;;;37;0;02/10/2024;outubro;37
LINHA 3;;;34;0;03/10/2024;outubro;34
LINHA 3;;;30;0;03/10/2024;outubro;30
LINHA 1;;;49;0;03/10/2024;outubro;49
LINHA 1;;;71;0;03/10/2024;outubro;71
CIRCULAR - 01;;;72;0;03/10/2024;outubro;72
CIRCULAR - 01;;;30;0;03/10/2024;outubro;30
CIRCULAR - 01;;;14;0;03/10/2024;outubro;14
LINHA 6;;;15;0;03/10/2024;outubro;15
LINHA 6;;;32;0;03/10/2024;outubro;32
LINHA 6;;;32;0;03/10/2024;outubro;32
CIRCULAR - 01;;;61;0;04/10/2024;outubro;61
CIRCULAR - 01;;;15;0;04/10/2024;outubro;15
CIRCULAR - 01;;;33;0;04/10/2024;outubro;33
LINHA 3;;;31;0;04/10/2024;outubro;31
LINHA 3;;;33;0;04/10/2024;outubro;33
LINHA 1;;;66;0;04/10/2024;outubro;66
LINHA 1;;;85;0;04/10/2024;outubro;85
LINHA 6;;;18;0;04/10/2024;outubro;18
LINHA 6;;;45;0;04/10/2024;outubro;45
LINHA 6;;;19;0;04/10/2024;outubro;19
LINHA 6;;;33;0;05/10/2024;outubro;33
LINHA 6;;;11;0;05/10/2024;outubro;11
CIRCULAR - 01;;;56;0;05/10/2024;outubro;56
CIRCULAR - 01;;;10;0;05/10/2024;outubro;10
CIRCULAR - 01;;;15;0;05/10/2024;outubro;15
LINHA 1;;;75;0;05/10/2024;outubro;75
LINHA 1;;;33;0;05/10/2024;outubro;33
LINHA 3;;;16;0;05/10/2024;outubro;16
LINHA 3;;;20;0;05/10/2024;outubro;20
LINHA 1;;;94;0;06/10/2024;outubro;94
LINHA 1;;;114;0;06/10/2024;outubro;114
CIRCULAR - 01;;;137;0;06/10/2024;outubro;137
CIRCULAR - 01;;;55;0;06/10/2024;outubro;55
LINHA 6;;;148;0;06/10/2024;outubro;148
LINHA 3;;;110;0;06/10/2024;outubro;110
LINHA 3;;;95;0;06/10/2024;outubro;95
LINHA 1;;;49;0;07/10/2024;outubro;49
LINHA 1;;;95;0;07/10/2024;outubro;95
CIRCULAR - 01;;;63;0;07/10/2024;outubro;63
CIRCULAR - 01;;;45;0;07/10/2024;outubro;45
LINHA 6;;;61;0;07/10/2024;outubro;61
LINHA 6;;;62;0;07/10/2024;outubro;62
LINHA 3;;;41;0;07/10/2024;outubro;41
LINHA 3;;;35;0;07/10/2024;outubro;35
CIRCULAR - 01;;;47;0;08/10/2024;outubro;47
CIRCULAR - 01;;;16;0;08/10/2024;outubro;16
CIRCULAR - 01;;;28;0;08/10/2024;outubro;28
LINHA 1;;;60;0;08/10/2024;outubro;60
LINHA 1;;;87;0;08/10/2024;outubro;87
LINHA 6;;;22;0;08/10/2024;outubro;22
LINHA 6;;;43;0;08/10/2024;outubro;43
LINHA 6;;;39;0;08/10/2024;outubro;39
LINHA 3;;;30;0;08/10/2024;outubro;30
LINHA 3;;;40;0;08/10/2024;outubro;40
LINHA 1;;;66;0;09/10/2024;outubro;66
LINHA 1;;;90;0;09/10/2024;outubro;90
LINHA 6;;;22;0;09/10/2024;outubro;22
LINHA 6;;;47;0;09/10/2024;outubro;47
LINHA 6;;;23;0;09/10/2024;outubro;23
LINHA 3;;;42;0;09/10/2024;outubro;42
LINHA 3;;;23;0;09/10/2024;outubro;23
CIRCULAR - 01;;;65;0;09/10/2024;outubro;65
CIRCULAR - 01;;;19;0;09/10/2024;outubro;19
CIRCULAR - 01;;;25;0;09/10/2024;outubro;25
LINHA 1;;;55;0;10/10/2024;outubro;55
LINHA 1;;;70;0;10/10/2024;outubro;70
LINHA 6;;;19;0;10/10/2024;outubro;19
LINHA 6;;;35;0;10/10/2024;outubro;35
LINHA 6;;;9;0;10/10/2024;outubro;9
LINHA 6;;;12;0;10/10/2024;outubro;12
LINHA 3;;;19;0;10/10/2024;outubro;19
LINHA 3;;;25;0;10/10/2024;outubro;25
CIRCULAR - 01;;;40;0;10/10/2024;outubro;40
CIRCULAR - 01;;;18;0;10/10/2024;outubro;18
CIRCULAR - 01;;;18;0;10/10/2024;outubro;18
LINHA 1;;;52;0;11/10/2024;outubro;52
LINHA 1;;;92;0;11/10/2024;outubro;92
LINHA 6;;;22;0;11/10/2024;outubro;22
LINHA 6;;;46;0;11/10/2024;outubro;46
LINHA 6;;;19;0;11/10/2024;outubro;19
LINHA 3;;;34;0;11/10/2024;outubro;34
LINHA 3;;;25;0;11/10/2024;outubro;25
CIRCULAR - 01;;;66;0;11/10/2024;outubro;66
CIRCULAR - 01;;;20;0;11/10/2024;outubro;20
CIRCULAR - 01;;;21;0;11/10/2024;outubro;21
LINHA 1;;;11;0;12/10/2024;outubro;11
LINHA 1;;;17;0;12/10/2024;outubro;17
LINHA 6;;;7;0;12/10/2024;outubro;7
LINHA 6;;;3;0;12/10/2024;outubro;3
LINHA 3;;;15;0;12/10/2024;outubro;15
LINHA 3;;;10;0;12/10/2024;outubro;10
CIRCULAR - 01;;;35;0;12/10/2024;outubro;35
CIRCULAR - 01;;;13;0;12/10/2024;outubro;13
LINHA 1;;;4;0;13/10/2024;outubro;4
LINHA 1;;;20;0;13/10/2024;outubro;20
LINHA 6;;;3;0;13/10/2024;outubro;3
LINHA 6;;;1;0;13/10/2024;outubro;1
LINHA 3;;;12;0;13/10/2024;outubro;12
LINHA 3;;;3;0;13/10/2024;outubro;3
CIRCULAR - 01;;;23;0;13/10/2024;outubro;23
CIRCULAR - 01;;;10;0;13/10/2024;outubro;10
LINHA 1;;;64;0;14/10/2024;outubro;64
LINHA 1;;;98;0;14/10/2024;outubro;98
LINHA 6;;;31;0;14/10/2024;outubro;31
LINHA 6;;;40;0;14/10/2024;outubro;40
LINHA 6;;;36;0;14/10/2024;outubro;36
LINHA 3;;;36;0;14/10/2024;outubro;36
LINHA 3;;;28;0;14/10/2024;outubro;28
CIRCULAR - 01;;;52;0;14/10/2024;outubro;52
CIRCULAR - 01;;;19;0;14/10/2024;outubro;19
CIRCULAR - 01;;;8;0;14/10/2024;outubro;8
LINHA 1;;;56;0;15/10/2024;outubro;56
LINHA 1;;;80;0;15/10/2024;outubro;80
LINHA 6;;;43;0;15/10/2024;outubro;43
LINHA 6;;;22;0;15/10/2024;outubro;22
LINHA 3;;;25;0;15/10/2024;outubro;25
CIRCULAR - 01;;;56;0;15/10/2024;outubro;56
CIRCULAR - 01;;;5;0;15/10/2024;outubro;5
CIRCULAR - 01;;;21;0;15/10/2024;outubro;21
LINHA 6;;;24;0;16/10/2024;outubro;24
LINHA 6;;;45;0;16/10/2024;outubro;45
LINHA 6;;;31;0;16/10/2024;outubro;31
LINHA 1;;;58;0;16/10/2024;outubro;58
LINHA 1;;;79;0;16/10/2024;outubro;79
LINHA 3;;;13;0;16/10/2024;outubro;13
LINHA 3;;;45;0;16/10/2024;outubro;45
LINHA 3;;;3;0;16/10/2024;outubro;3
CIRCULAR - 01;;;65;0;16/10/2024;outubro;65
CIRCULAR - 01;;;21;0;16/10/2024;outubro;21
CIRCULAR - 01;;;14;0;16/10/2024;outubro;14
LINHA 6;;;24;0;17/10/2024;outubro;24
LINHA 6;;;41;0;17/10/2024;outubro;41
LINHA 6;;;31;0;17/10/2024;outubro;31
LINHA 1;;;31;0;17/10/2024;outubro;31
LINHA 3;;;29;0;17/10/2024;outubro;29
LINHA 3;;;22;0;17/10/2024;outubro;22
LINHA 1;;;21;0;17/10/2024;outubro;21
LINHA 1;;;90;0;17/10/2024;outubro;90
CIRCULAR - 01;;;57;0;17/10/2024;outubro;57
CIRCULAR - 01;;;16;0;17/10/2024;outubro;16
CIRCULAR - 01;;;18;0;17/10/2024;outubro;18
LINHA 6;;;35;0;18/10/2024;outubro;35
LINHA 6;;;39;0;18/10/2024;outubro;39
LINHA 6;;;23;0;18/10/2024;outubro;23
LINHA 3;;;13;0;18/10/2024;outubro;13
LINHA 1;;;58;0;18/10/2024;outubro;58
LINHA 1;;;66;0;18/10/2024;outubro;66
LINHA 3;;;32;0;18/10/2024;outubro;32
LINHA 3;;;3;0;18/10/2024;outubro;3
LINHA 3;;;64;0;18/10/2024;outubro;64
CIRCULAR - 01;;;16;0;18/10/2024;outubro;16
CIRCULAR - 01;;;20;0;18/10/2024;outubro;20
LINHA 1;;;73;0;19/10/2024;outubro;73
LINHA 1;;;20;0;19/10/2024;outubro;20
LINHA 3;;;20;0;19/10/2024;outubro;20
LINHA 3;;;7;0;19/10/2024;outubro;7
LINHA 6;;;25;0;19/10/2024;outubro;25
LINHA 6;;;10;0;19/10/2024;outubro;10
CIRCULAR - 01;;;48;0;19/10/2024;outubro;48
CIRCULAR - 01;;;13;0;19/10/2024;outubro;13
CIRCULAR - 01;;;6;0;19/10/2024;outubro;6
LINHA 1;;;9;0;20/10/2024;outubro;9
LINHA 1;;;6;0;20/10/2024;outubro;6
CIRCULAR - 01;;;14;0;20/10/2024;outubro;14
CIRCULAR - 01;;;5;0;20/10/2024;outubro;5
CIRCULAR - 01;;;2;0;20/10/2024;outubro;2
LINHA 3;;;6;0;20/10/2024;outubro;6
LINHA 3;;;2;0;20/10/2024;outubro;2
LINHA 1;;;37;0;21/10/2024;outubro;37
LINHA 1;;;62;0;21/10/2024;outubro;62
CIRCULAR - 01;;;64;0;21/10/2024;outubro;64
CIRCULAR - 01;;;57;0;21/10/2024;outubro;57
LINHA 6;;;29;0;21/10/2024;outubro;29
LINHA 6;;;15;0;21/10/2024;outubro;15
LINHA 6;;;15;0;21/10/2024;outubro;15
LINHA 1;;;51;0;22/10/2024;outubro;51
LINHA 1;;;64;0;22/10/2024;outubro;64
CIRCULAR - 01;;;65;0;22/10/2024;outubro;65
CIRCULAR - 01;;;18;0;22/10/2024;outubro;18
CIRCULAR - 01;;;17;0;22/10/2024;outubro;17
LINHA 3;;;32;0;22/10/2024;outubro;32
LINHA 3;;;32;0;22/10/2024;outubro;32
LINHA 6;;;21;0;22/10/2024;outubro;21
LINHA 6;;;34;0;22/10/2024;outubro;34
LINHA 6;;;16;0;22/10/2024;outubro;16
LINHA 1;;;46;0;23/10/2024;outubro;46
LINHA 1;;;59;0;23/10/2024;outubro;59
CIRCULAR - 01;;;54;0;23/10/2024;outubro;54
CIRCULAR - 01;;;29;0;23/10/2024;outubro;29
CIRCULAR - 01;;;20;0;23/10/2024;outubro;20
LINHA 3;;;28;0;23/10/2024;outubro;28
LINHA 3;;;28;0;23/10/2024;outubro;28
LINHA 6;;;21;0;23/10/2024;outubro;21
LINHA 6;;;49;0;23/10/2024;outubro;49
LINHA 6;;;13;0;23/10/2024;outubro;13
LINHA 3;;;38;0;24/10/2024;outubro;38
LINHA 3;;;22;0;24/10/2024;outubro;22
CIRCULAR - 01;;;60;0;24/10/2024;outubro;60
CIRCULAR - 01;;;18;0;24/10/2024;outubro;18
CIRCULAR - 01;;;16;0;24/10/2024;outubro;16
LINHA 1;;;36;0;24/10/2024;outubro;36
LINHA 1;;;62;0;24/10/2024;outubro;62
LINHA 6;;;21;0;24/10/2024;outubro;21
LINHA 6;;;26;0;24/10/2024;outubro;26
LINHA 6;;;19;0;24/10/2024;outubro;19
LINHA 1;;;38;0;25/10/2024;outubro;38
LINHA 1;;;71;0;25/10/2024;outubro;71
CIRCULAR - 01;;;55;0;25/10/2024;outubro;55
CIRCULAR - 01;;;16;0;25/10/2024;outubro;16
CIRCULAR - 01;;;15;0;25/10/2024;outubro;15
LINHA 3;;;40;0;25/10/2024;outubro;40
LINHA 3;;;25;0;25/10/2024;outubro;25
LINHA 6;;;3;0;25/10/2024;outubro;3
LINHA 6;;;26;0;25/10/2024;outubro;26
LINHA 6;;;21;0;25/10/2024;outubro;21
LINHA 1;;;56;0;26/10/2024;outubro;56
LINHA 1;;;12;0;26/10/2024;outubro;12
CIRCULAR - 01;;;33;0;26/10/2024;outubro;33
CIRCULAR - 01;;;7;0;26/10/2024;outubro;7
CIRCULAR - 01;;;12;0;26/10/2024;outubro;12
LINHA 3;;;28;0;26/10/2024;outubro;28
LINHA 3;;;14;0;26/10/2024;outubro;14
LINHA 6;;;30;0;26/10/2024;outubro;30
LINHA 6;;;8;0;26/10/2024;outubro;8
LINHA 1;;;7;0;27/10/2024;outubro;7
LINHA 1;;;14;0;27/10/2024;outubro;14
CIRCULAR - 01;;;2;0;27/10/2024;outubro;2
LINHA 3;;;14;0;27/10/2024;outubro;14
LINHA 3;;;14;0;27/10/2024;outubro;14
LINHA 6;;;8;0;27/10/2024;outubro;8
LINHA 6;;;1;0;27/10/2024;outubro;1
CIRCULAR - 01;;;13;0;27/10/2024;outubro;13
CIRCULAR - 01;;;3;0;27/10/2024;outubro;3
CIRCULAR - 01;;;8;0;27/10/2024;outubro;8
LINHA 1;;;49;0;28/10/2024;outubro;49
LINHA 1;;;75;0;28/10/2024;outubro;75
LINHA 3;;;28;0;28/10/2024;outubro;28
LINHA 3;;;21;0;28/10/2024;outubro;21
CIRCULAR - 01;;;3;0;28/10/2024;outubro;3
LINHA 6;;;17;0;28/10/2024;outubro;17
LINHA 6;;;57;0;28/10/2024;outubro;57
CIRCULAR - 01;;;41;0;28/10/2024;outubro;41
CIRCULAR - 01;;;16;0;28/10/2024;outubro;16
CIRCULAR - 01;;;10;0;28/10/2024;outubro;10
LINHA 1;;;37;0;29/10/2024;outubro;37
LINHA 1;;;68;0;29/10/2024;outubro;68
CIRCULAR - 01;;;73;0;29/10/2024;outubro;73
CIRCULAR - 01;;;15;0;29/10/2024;outubro;15
CIRCULAR - 01;;;12;0;29/10/2024;outubro;12
LINHA 6;;;22;0;29/10/2024;outubro;22
LINHA 6;;;44;0;29/10/2024;outubro;44
LINHA 6;;;19;0;29/10/2024;outubro;19
LINHA 3;;;20;0;29/10/2024;outubro;20
LINHA 3;;;23;0;30/10/2024;outubro;23
LINHA 3;;;45;0;30/10/2024;outubro;45
LINHA 1;;;45;0;30/10/2024;outubro;45
LINHA 1;;;80;0;30/10/2024;outubro;80
CIRCULAR - 01;;;71;0;30/10/2024;outubro;71
CIRCULAR - 01;;;26;0;30/10/2024;outubro;26
CIRCULAR - 01;;;16;0;30/10/2024;outubro;16
LINHA 6;;;13;0;30/10/2024;outubro;13
LINHA 6;;;35;0;30/10/2024;outubro;35
LINHA 6;;;21;0;30/10/2024;outubro;21
LINHA 3;;;26;0;31/10/2024;outubro;26
LINHA 3;;;32;0;31/10/2024;outubro;32
LINHA 1;;;53;0;31/10/2024;outubro;53
LINHA 1;;;61;0;31/10/2024;outubro;61
CIRCULAR - 01;;;64;0;31/10/2024;outubro;64
CIRCULAR - 01;;;36;0;31/10/2024;outubro;36
CIRCULAR - 01;;;14;0;31/10/2024;outubro;14
LINHA 6;;;12;0;31/10/2024;outubro;12
LINHA 6;;;33;0;31/10/2024;outubro;33
LINHA 6;;;37;0;31/10/2024;outubro;37
LINHA 3;;;31;0;01/11/2024;novembro;31
LINHA 3;;;34;0;01/11/2024;novembro;34
LINHA 1;;;38;0;01/11/2024;novembro;38
LINHA 1;;;71;0;01/11/2024;novembro;71
CIRCULAR - 01;;;63;0;01/11/2024;novembro;63
CIRCULAR - 01;;;27;0;01/11/2024;novembro;27
CIRCULAR - 01;;;17;0;01/11/2024;novembro;17
LINHA 6;;;19;0;01/11/2024;novembro;19
LINHA 6;;;71;0;01/11/2024;novembro;71
CIRCULAR - 01;;;42;0;02/11/2024;novembro;42
CIRCULAR - 01;;;7;0;02/11/2024;novembro;7
CIRCULAR - 01;;;8;0;02/11/2024;novembro;8
LINHA 1;;;6;0;02/11/2024;novembro;6
LINHA 1;;;25;0;02/11/2024;novembro;25
LINHA 3;;;17;0;02/11/2024;novembro;17
LINHA 3;;;3;0;02/11/2024;novembro;3
LINHA 6;;;28;0;02/11/2024;novembro;28
LINHA 6;;;7;0;02/11/2024;novembro;7
CIRCULAR - 01;;;18;0;03/11/2024;novembro;18
CIRCULAR - 01;;;5;0;03/11/2024;novembro;5
CIRCULAR - 01;;;7;0;03/11/2024;novembro;7
LINHA 1;;;4;0;03/11/2024;novembro;4
LINHA 1;;;10;0;03/11/2024;novembro;10
LINHA 3;;;5;0;03/11/2024;novembro;5
LINHA 3;;;4;0;03/11/2024;novembro;4
LINHA 6;;;3;0;03/11/2024;novembro;3
LINHA 6;;;2;0;03/11/2024;novembro;2
LINHA 1;;;65;0;04/11/2024;novembro;65
LINHA 1;;;54;0;04/11/2024;novembro;54
CIRCULAR - 01;;;46;0;04/11/2024;novembro;46
CIRCULAR - 01;;;25;0;04/11/2024;novembro;25
CIRCULAR - 01;;;18;0;04/11/2024;novembro;18
LINHA 6;;;19;0;04/11/2024;novembro;19
LINHA 6;;;43;0;04/11/2024;novembro;43
LINHA 6;;;21;0;04/11/2024;novembro;21
LINHA 3;;;45;0;04/11/2024;novembro;45
LINHA 3;;;35;0;04/11/2024;novembro;35
LINHA 1;;;54;0;05/11/2024;novembro;54
LINHA 1;;;86;0;05/11/2024;novembro;86
CIRCULAR - 01;;;78;0;05/11/2024;novembro;78
CIRCULAR - 01;;;14;0;05/11/2024;novembro;14
CIRCULAR - 01;;;23;0;05/11/2024;novembro;23
LINHA 6;;;24;0;05/11/2024;novembro;24
LINHA 6;;;44;0;05/11/2024;novembro;44
LINHA 6;;;28;0;05/11/2024;novembro;28
LINHA 3;;;29;0;05/11/2024;novembro;29
LINHA 3;;;50;0;05/11/2024;novembro;50
LINHA 1;;;51;0;06/11/2024;novembro;51
LINHA 1;;;70;0;06/11/2024;novembro;70
CIRCULAR - 01;;;83;0;06/11/2024;novembro;83
CIRCULAR - 01;;;25;0;06/11/2024;novembro;25
CIRCULAR - 01;;;14;0;06/11/2024;novembro;14
LINHA 6;;;14;0;06/11/2024;novembro;14
LINHA 6;;;49;0;06/11/2024;novembro;49
LINHA 6;;;28;0;06/11/2024;novembro;28
LINHA 3;;;52;0;06/11/2024;novembro;52
LINHA 3;;;34;0;06/11/2024;novembro;34
LINHA 1;;;65;0;07/11/2024;novembro;65
LINHA 1;;;83;0;07/11/2024;novembro;83
CIRCULAR - 01;;;60;0;07/11/2024;novembro;60
CIRCULAR - 01;;;20;0;07/11/2024;novembro;20
CIRCULAR - 01;;;25;0;07/11/2024;novembro;25
LINHA 6;;;20;0;07/11/2024;novembro;20
LINHA 6;;;46;0;07/11/2024;novembro;46
LINHA 6;;;29;0;07/11/2024;novembro;29
LINHA 3;;;41;0;07/11/2024;novembro;41
LINHA 3;;;29;0;07/11/2024;novembro;29
LINHA 1;;;66;0;08/11/2024;novembro;66
LINHA 1;;;64;0;08/11/2024;novembro;64
CIRCULAR - 01;;;54;0;08/11/2024;novembro;54
CIRCULAR - 01;;;26;0;08/11/2024;novembro;26
CIRCULAR - 01;;;24;0;08/11/2024;novembro;24
LINHA 6;;;27;0;08/11/2024;novembro;27
LINHA 6;;;46;0;08/11/2024;novembro;46
LINHA 6;;;33;0;08/11/2024;novembro;33
LINHA 3;;;42;0;08/11/2024;novembro;42
LINHA 3;;;28;0;08/11/2024;novembro;28
LINHA 1;;;57;0;09/11/2024;novembro;57
LINHA 1;;;5;0;09/11/2024;novembro;5
LINHA 3;;;0;0;09/11/2024;novembro;0
LINHA 3;;;20;0;09/11/2024;novembro;20
LINHA 3;;;1;0;09/11/2024;novembro;1
LINHA 6;;;33;0;09/11/2024;novembro;33
LINHA 6;;;12;0;09/11/2024;novembro;12
LINHA 3;;;3;0;09/11/2024;novembro;3
LINHA 1;;;12;0;09/11/2024;novembro;12
CIRCULAR - 01;;;40;0;09/11/2024;novembro;40
CIRCULAR - 01;;;15;0;09/11/2024;novembro;15
CIRCULAR - 01;;;9;0;09/11/2024;novembro;9
CIRCULAR - 01;;;13;0;10/11/2024;novembro;13
CIRCULAR - 01;;;1;0;10/11/2024;novembro;1
CIRCULAR - 01;;;8;0;10/11/2024;novembro;8
LINHA 1;;;3;0;10/11/2024;novembro;3
LINHA 1;;;4;0;10/11/2024;novembro;4
LINHA 3;;;0;0;10/11/2024;novembro;0
LINHA 3;;;3;0;10/11/2024;novembro;3
LINHA 6;;;8;0;10/11/2024;novembro;8
LINHA 6;;;4;0;10/11/2024;novembro;4
LINHA 3;;;52;0;11/11/2024;novembro;52
LINHA 3;;;24;0;11/11/2024;novembro;24
LINHA 1;;;62;0;11/11/2024;novembro;62
LINHA 1;;;101;0;11/11/2024;novembro;101
CIRCULAR - 01;;;68;0;11/11/2024;novembro;68
CIRCULAR - 01;;;29;0;11/11/2024;novembro;29
CIRCULAR - 01;;;19;0;11/11/2024;novembro;19
LINHA 6;;;18;0;11/11/2024;novembro;18
LINHA 6;;;46;0;11/11/2024;novembro;46
LINHA 6;;;32;0;11/11/2024;novembro;32
LINHA 3;;;34;0;12/11/2024;novembro;34
LINHA 1;;;57;0;12/11/2024;novembro;57
LINHA 1;;;98;0;12/11/2024;novembro;98
LINHA 3;;;25;0;12/11/2024;novembro;25
CIRCULAR - 01;;;75;0;12/11/2024;novembro;75
CIRCULAR - 01;;;22;0;12/11/2024;novembro;22
CIRCULAR - 01;;;21;0;12/11/2024;novembro;21
LINHA 6;;;19;0;12/11/2024;novembro;19
LINHA 6;;;51;0;12/11/2024;novembro;51
LINHA 6;;;30;0;12/11/2024;novembro;30
LINHA 1;;;54;0;13/11/2024;novembro;54
LINHA 1;;;79;0;13/11/2024;novembro;79
LINHA 3;;;34;0;13/11/2024;novembro;34
LINHA 3;;;17;0;13/11/2024;novembro;17
CIRCULAR - 01;;;77;0;13/11/2024;novembro;77
CIRCULAR - 01;;;16;0;13/11/2024;novembro;16
CIRCULAR - 01;;;14;0;13/11/2024;novembro;14
LINHA 6;;;21;0;13/11/2024;novembro;21
LINHA 6;;;32;0;13/11/2024;novembro;32
LINHA 6;;;31;0;13/11/2024;novembro;31
LINHA 1;;;33;93;14/11/2024;novembro;126
LINHA 1;;;86;71;14/11/2024;novembro;157
LINHA 3;;;40;0;14/11/2024;novembro;40
LINHA 3;;;29;0;14/11/2024;novembro;29
CIRCULAR - 01;;;58;0;14/11/2024;novembro;58
CIRCULAR - 01;;;16;0;14/11/2024;novembro;16
CIRCULAR - 01;;;22;0;14/11/2024;novembro;22
LINHA 1;;;13;0;14/11/2024;novembro;13
LINHA 6;;;15;0;14/11/2024;novembro;15
LINHA 6;;;36;0;14/11/2024;novembro;36
LINHA 6;;;24;0;14/11/2024;novembro;24
LINHA 1;;;6;8;15/11/2024;novembro;14
LINHA 1;;;13;18;15/11/2024;novembro;31
CIRCULAR - 01;;;11;0;15/11/2024;novembro;11
CIRCULAR - 01;;;7;0;15/11/2024;novembro;7
CIRCULAR - 01;;;4;0;15/11/2024;novembro;4
LINHA 6;;;7;20;15/11/2024;novembro;27
LINHA 6;;;7;3;15/11/2024;novembro;10
LINHA 3;;;2;0;15/11/2024;novembro;2
LINHA 3;;;5;0;15/11/2024;novembro;5
LINHA 1;;;37;49;16/11/2024;novembro;86
LINHA 1;;;18;18;16/11/2024;novembro;36
LINHA 6;;;12;0;16/11/2024;novembro;12
CIRCULAR - 01;;;15;0;16/11/2024;novembro;15
LINHA 3;;;11;12;16/11/2024;novembro;23
LINHA 3;;;16;11;16/11/2024;novembro;27
LINHA 6;;;27;0;16/11/2024;novembro;27
CIRCULAR - 01;;;1;0;16/11/2024;novembro;1
CIRCULAR - 01;;;12;0;16/11/2024;novembro;12
CIRCULAR - 01;;;9;0;16/11/2024;novembro;9
LINHA 1;;;5;11;17/11/2024;novembro;16
LINHA 1;;;21;24;17/11/2024;novembro;45
LINHA 3;;;2;0;17/11/2024;novembro;2
LINHA 3;;;2;0;17/11/2024;novembro;2
LINHA 6;;;8;20;17/11/2024;novembro;28
LINHA 6;;;2;7;17/11/2024;novembro;9
CIRCULAR - 01;;;13;0;17/11/2024;novembro;13
CIRCULAR - 01;;;1;0;17/11/2024;novembro;1
CIRCULAR - 01;;;12;0;17/11/2024;novembro;12
LINHA 1;;;59;102;18/11/2024;novembro;161
LINHA 1;;;86;63;18/11/2024;novembro;149
LINHA 3;;;32;0;18/11/2024;novembro;32
LINHA 3;;;27;0;18/11/2024;novembro;27
LINHA 6;;;25;43;18/11/2024;novembro;68
LINHA 6;;;51;88;18/11/2024;novembro;139
LINHA 6;;;23;20;18/11/2024;novembro;43
CIRCULAR - 01;;;71;0;18/11/2024;novembro;71
CIRCULAR - 01;;;21;0;18/11/2024;novembro;21
CIRCULAR - 01;;;16;0;18/11/2024;novembro;16
LINHA 1;;;69;110;19/11/2024;novembro;179
LINHA 1;;;80;66;19/11/2024;novembro;146
LINHA 3;;;34;0;19/11/2024;novembro;34
LINHA 6;;;21;49;19/11/2024;novembro;70
LINHA 6;;;36;78;19/11/2024;novembro;114
LINHA 6;;;25;34;19/11/2024;novembro;59
CIRCULAR - 01;;;59;0;19/11/2024;novembro;59
CIRCULAR - 01;;;34;0;19/11/2024;novembro;34
CIRCULAR - 01;;;24;0;19/11/2024;novembro;24
LINHA 1;;;11;30;20/11/2024;novembro;41
LINHA 1;;;16;17;20/11/2024;novembro;33
LINHA 3;;;10;0;20/11/2024;novembro;10
LINHA 3;;;3;0;20/11/2024;novembro;3
LINHA 6;;;8;34;20/11/2024;novembro;42
LINHA 6;;;13;10;20/11/2024;novembro;23
CIRCULAR - 01;;;23;0;20/11/2024;novembro;23
CIRCULAR - 01;;;10;0;20/11/2024;novembro;10
CIRCULAR - 01;;;14;0;20/11/2024;novembro;14
LINHA 1;;;62;108;21/11/2024;novembro;170
LINHA 1;;;90;71;21/11/2024;novembro;161
LINHA 3;;;30;0;21/11/2024;novembro;30
LINHA 3;;;36;0;21/11/2024;novembro;36
LINHA 6;;;23;0;21/11/2024;novembro;23
LINHA 6;;;39;0;21/11/2024;novembro;39
LINHA 6;;;23;0;21/11/2024;novembro;23
CIRCULAR - 01;;;40;0;21/11/2024;novembro;40
CIRCULAR - 01;;;23;0;21/11/2024;novembro;23
CIRCULAR - 01;;;24;0;21/11/2024;novembro;24
LINHA 1;;;73;111;22/11/2024;novembro;184
LINHA 1;;;76;58;22/11/2024;novembro;134
LINHA 6;;;20;0;22/11/2024;novembro;20
LINHA 6;;;42;0;22/11/2024;novembro;42
LINHA 6;;;18;0;22/11/2024;novembro;18
LINHA 3;;;34;41;22/11/2024;novembro;75
LINHA 3;;;29;15;22/11/2024;novembro;44
CIRCULAR - 01;;;43;0;22/11/2024;novembro;43
CIRCULAR - 01;;;22;0;22/11/2024;novembro;22
CIRCULAR - 01;;;20;0;22/11/2024;novembro;20
LINHA 1;;;29;49;23/11/2024;novembro;78
LINHA 1;;;34;15;23/11/2024;novembro;49
LINHA 3;;;20;0;23/11/2024;novembro;20
LINHA 6;;;28;0;23/11/2024;novembro;28
LINHA 6;;;8;0;23/11/2024;novembro;8
CIRCULAR - 01;;;38;58;23/11/2024;novembro;96
CIRCULAR - 01;;;35;31;23/11/2024;novembro;66
CIRCULAR - 01;;;15;8;23/11/2024;novembro;23
LINHA 1;;;5;17;24/11/2024;novembro;22
LINHA 1;;;2;5;24/11/2024;novembro;7
LINHA 3;;;0;0;24/11/2024;novembro;0
LINHA 3;;;17;0;24/11/2024;novembro;17
LINHA 6;;;8;0;24/11/2024;novembro;8
LINHA 6;;;1;0;24/11/2024;novembro;1
CIRCULAR - 01;;;24;25;24/11/2024;novembro;49
CIRCULAR - 01;;;0;1;24/11/2024;novembro;1
CIRCULAR - 01;;;13;16;24/11/2024;novembro;29
LINHA 1;;;6;0;24/11/2024;novembro;6
CIRCULAR - 01;;;49;99;25/11/2024;novembro;148
CIRCULAR - 01;;;24;26;25/11/2024;novembro;50
LINHA 3;;;25;0;25/11/2024;novembro;25
LINHA 1;;;42;105;25/11/2024;novembro;147
LINHA 1;;;84;98;25/11/2024;novembro;182
LINHA 6;;;42;0;25/11/2024;novembro;42
LINHA 6;;;52;0;25/11/2024;novembro;52
LINHA 1;;;45;0;26/11/2024;novembro;45
LINHA 1;;;102;0;26/11/2024;novembro;102
CIRCULAR - 01;;;61;0;26/11/2024;novembro;61
CIRCULAR - 01;;;20;0;26/11/2024;novembro;20
LINHA 3;;;32;49;26/11/2024;novembro;81
LINHA 3;;;28;31;26/11/2024;novembro;59
LINHA 6;;;55;0;26/11/2024;novembro;55
LINHA 3;;;37;32;27/11/2024;novembro;69
LINHA 1;;;52;0;27/11/2024;novembro;52
LINHA 1;;;64;0;27/11/2024;novembro;64
CIRCULAR - 01;;;53;0;27/11/2024;novembro;53
CIRCULAR - 01;;;24;0;27/11/2024;novembro;24
LINHA 6;;;39;0;27/11/2024;novembro;39
LINHA 6;;;48;0;27/11/2024;novembro;48
LINHA 1;;;55;0;28/11/2024;novembro;55
LINHA 1;;;69;0;28/11/2024;novembro;69
CIRCULAR - 01;;;62;0;28/11/2024;novembro;62
CIRCULAR - 01;;;13;0;28/11/2024;novembro;13
CIRCULAR - 01;;;18;0;28/11/2024;novembro;18
LINHA 3;;;37;12;28/11/2024;novembro;49
LINHA 3;;;21;28;28/11/2024;novembro;49
LINHA 6;;;22;0;28/11/2024;novembro;22
LINHA 6;;;24;0;28/11/2024;novembro;24
LINHA 6;;;22;0;28/11/2024;novembro;22
LINHA 1;;;55;0;29/11/2024;novembro;55
LINHA 1;;;94;0;29/11/2024;novembro;94
CIRCULAR - 01;;;84;0;29/11/2024;novembro;84
CIRCULAR - 01;;;24;0;29/11/2024;novembro;24
CIRCULAR - 01;;;21;0;29/11/2024;novembro;21
LINHA 3;;;35;40;29/11/2024;novembro;75
LINHA 3;;;22;24;29/11/2024;novembro;46
LINHA 6;;;22;0;29/11/2024;novembro;22
LINHA 6;;;25;0;29/11/2024;novembro;25
LINHA 6;;;34;0;29/11/2024;novembro;34
LINHA 6;;;27;74;30/11/2024;novembro;101
LINHA 6;;;11;18;30/11/2024;novembro;29
CIRCULAR - 01;;;53;0;30/11/2024;novembro;53
CIRCULAR - 01;;;26;0;30/11/2024;novembro;26
CIRCULAR - 01;;;10;0;30/11/2024;novembro;10
LINHA 1;;;78;96;30/11/2024;novembro;174
LINHA 1;;;54;19;30/11/2024;novembro;73
LINHA 3;;;11;0;30/11/2024;novembro;11
LINHA 3;;;24;0;30/11/2024;novembro;24
CIRCULAR - 01;;;20;31;01/12/2024;dezembro;51
CIRCULAR - 01;;;9;11;01/12/2024;dezembro;20
CIRCULAR - 01;;;22;15;01/12/2024;dezembro;37
LINHA 3;;;5;0;01/12/2024;dezembro;5
LINHA 3;;;4;0;01/12/2024;dezembro;4
LINHA 6;;;7;19;01/12/2024;dezembro;26
LINHA 6;;;3;5;01/12/2024;dezembro;8
LINHA 1;;;8;0;01/12/2024;dezembro;8
LINHA 1;;;15;0;01/12/2024;dezembro;15
CIRCULAR - 01;;;101;133;02/12/2024;dezembro;234
CIRCULAR - 01;;;28;51;02/12/2024;dezembro;79
CIRCULAR - 01;;;3;4;02/12/2024;dezembro;7
LINHA 3;;;20;25;02/12/2024;dezembro;45
LINHA 3;;;40;0;02/12/2024;dezembro;40
LINHA 6;;;24;45;02/12/2024;dezembro;69
LINHA 6;;;35;66;02/12/2024;dezembro;101
LINHA 6;;;27;20;02/12/2024;dezembro;47
LINHA 1;;;56;103;02/12/2024;dezembro;159
LINHA 1;;;65;54;02/12/2024;dezembro;119
LINHA 1;;;59;118;03/12/2024;dezembro;177
LINHA 1;;;88;79;03/12/2024;dezembro;167
CIRCULAR - 01;;;61;126;03/12/2024;dezembro;187
CIRCULAR - 01;;;13;41;03/12/2024;dezembro;54
CIRCULAR - 01;;;20;9;03/12/2024;dezembro;29
LINHA 6;;;19;37;03/12/2024;dezembro;56
LINHA 6;;;43;79;03/12/2024;dezembro;122
LINHA 6;;;18;22;03/12/2024;dezembro;40
LINHA 3;;;42;39;03/12/2024;dezembro;81
LINHA 3;;;26;34;03/12/2024;dezembro;60
LINHA 3;;;50;39;04/12/2024;dezembro;89
LINHA 3;;;2;3;04/12/2024;dezembro;5
CIRCULAR - 01;;;84;103;04/12/2024;dezembro;187
CIRCULAR - 01;;;44;40;04/12/2024;dezembro;84
CIRCULAR - 01;;;4;2;04/12/2024;dezembro;6
LINHA 1;;;6;8;04/12/2024;dezembro;14
LINHA 3;;;32;19;04/12/2024;dezembro;51
CIRCULAR - 01;;;17;33;04/12/2024;dezembro;50
CIRCULAR - 01;;;16;60;04/12/2024;dezembro;76
CIRCULAR - 01;;;29;19;04/12/2024;dezembro;48
LINHA 1;;;42;97;04/12/2024;dezembro;139
LINHA 1;;;64;73;04/12/2024;dezembro;137
CIRCULAR - 01;;;58;64;05/12/2024;dezembro;122
CIRCULAR - 01;;;27;34;05/12/2024;dezembro;61
CIRCULAR - 01;;;14;19;05/12/2024;dezembro;33
CIRCULAR - 01;;;6;0;05/12/2024;dezembro;6
LINHA 1;;;47;97;05/12/2024;dezembro;144
LINHA 1;;;83;52;05/12/2024;dezembro;135
LINHA 6;;;19;34;05/12/2024;dezembro;53
LINHA 6;;;32;52;05/12/2024;dezembro;84
LINHA 6;;;12;24;05/12/2024;dezembro;36
LINHA 3;;;34;38;05/12/2024;dezembro;72
LINHA 3;;;37;23;05/12/2024;dezembro;60
LINHA 6;;;11;24;06/12/2024;dezembro;35
CIRCULAR - 01;;;83;117;06/12/2024;dezembro;200
CIRCULAR - 01;;;28;37;06/12/2024;dezembro;65
CIRCULAR - 01;;;12;12;06/12/2024;dezembro;24
CIRCULAR - 01;;;8;4;06/12/2024;dezembro;12
LINHA 1;;;44;152;06/12/2024;dezembro;196
LINHA 1;;;119;107;06/12/2024;dezembro;226
LINHA 6;;;15;19;06/12/2024;dezembro;34
LINHA 6;;;36;80;06/12/2024;dezembro;116
LINHA 6;;;29;26;06/12/2024;dezembro;55
LINHA 3;;;37;57;06/12/2024;dezembro;94
LINHA 3;;;29;19;06/12/2024;dezembro;48
CIRCULAR - 01;;;30;76;07/12/2024;dezembro;106
CIRCULAR - 01;;;28;24;07/12/2024;dezembro;52
CIRCULAR - 01;;;14;11;07/12/2024;dezembro;25
LINHA 3;;;8;21;07/12/2024;dezembro;29
LINHA 3;;;19;13;07/12/2024;dezembro;32
LINHA 1;;;66;97;07/12/2024;dezembro;163
LINHA 1;;;36;20;07/12/2024;dezembro;56
LINHA 4;;;0;0;07/12/2024;dezembro;0
LINHA 6;;;31;87;07/12/2024;dezembro;118
LINHA 6;;;23;29;07/12/2024;dezembro;52
CIRCULAR - 01;;;8;9;08/12/2024;dezembro;17
CIRCULAR - 01;;;4;7;08/12/2024;dezembro;11
CIRCULAR - 01;;;14;14;08/12/2024;dezembro;28
LINHA 3;;;5;5;08/12/2024;dezembro;10
LINHA 3;;;14;9;08/12/2024;dezembro;23
LINHA 1;;;13;17;08/12/2024;dezembro;30
LINHA 1;;;17;21;08/12/2024;dezembro;38
LINHA 6;;;7;27;08/12/2024;dezembro;34
LINHA 6;;;6;6;08/12/2024;dezembro;12
CIRCULAR - 01;;;83;108;09/12/2024;dezembro;191
CIRCULAR - 01;;;27;42;09/12/2024;dezembro;69
CIRCULAR - 01;;;28;21;09/12/2024;dezembro;49
LINHA 3;;;40;50;09/12/2024;dezembro;90
LINHA 3;;;46;22;09/12/2024;dezembro;68
LINHA 1;;;69;114;09/12/2024;dezembro;183
LINHA 1;;;90;68;09/12/2024;dezembro;158
LINHA 4;;;1;1;09/12/2024;dezembro;2
LINHA 6;;;23;45;09/12/2024;dezembro;68
LINHA 6;;;51;92;09/12/2024;dezembro;143
LINHA 6;;;29;27;09/12/2024;dezembro;56
CIRCULAR - 01;;;65;105;10/12/2024;dezembro;170
CIRCULAR - 01;;;31;42;10/12/2024;dezembro;73
CIRCULAR - 01;;;23;20;10/12/2024;dezembro;43
LINHA 3;;;34;41;10/12/2024;dezembro;75
LINHA 3;;;28;19;10/12/2024;dezembro;47
LINHA 1;;;49;100;10/12/2024;dezembro;149
LINHA 1;;;92;103;10/12/2024;dezembro;195
LINHA 4;;;1;1;10/12/2024;dezembro;2
LINHA 4;;;6;3;10/12/2024;dezembro;9
LINHA 6;;;18;35;10/12/2024;dezembro;53
LINHA 6;;;38;72;10/12/2024;dezembro;110
LINHA 6;;;17;23;10/12/2024;dezembro;40
LINHA 6;;;7;10;10/12/2024;dezembro;17
CIRCULAR - 01;;;79;97;11/12/2024;dezembro;176
CIRCULAR - 01;;;30;30;11/12/2024;dezembro;60
CIRCULAR - 01;;;15;24;11/12/2024;dezembro;39
LINHA 3;;;45;38;11/12/2024;dezembro;83
LINHA 3;;;36;24;11/12/2024;dezembro;60
LINHA 1;;;59;93;11/12/2024;dezembro;152
LINHA 1;;;80;68;11/12/2024;dezembro;148
LINHA 4;;;4;4;11/12/2024;dezembro;8
LINHA 4;;;11;3;11/12/2024;dezembro;14
LINHA 6;;;19;37;11/12/2024;dezembro;56
LINHA 6;;;28;51;11/12/2024;dezembro;79
LINHA 6;;;34;28;11/12/2024;dezembro;62
CIRCULAR - 01;;;71;103;12/12/2024;dezembro;174
CIRCULAR - 01;;;26;25;12/12/2024;dezembro;51
CIRCULAR - 01;;;16;10;12/12/2024;dezembro;26
LINHA 6;;;27;43;12/12/2024;dezembro;70
LINHA 6;;;13;30;12/12/2024;dezembro;43
LINHA 6;;;29;34;12/12/2024;dezembro;63
LINHA 6;;;3;3;12/12/2024;dezembro;6
LINHA 1;;;48;88;12/12/2024;dezembro;136
LINHA 1;;;85;72;12/12/2024;dezembro;157
LINHA 4;;;1;2;12/12/2024;dezembro;3
LINHA 4;;;9;1;12/12/2024;dezembro;10
LINHA 3;;;15;12;12/12/2024;dezembro;27
LINHA 3;;;42;20;12/12/2024;dezembro;62
CIRCULAR - 01;;;70;91;13/12/2024;dezembro;161
CIRCULAR - 01;;;14;20;13/12/2024;dezembro;34
CIRCULAR - 01;;;28;15;13/12/2024;dezembro;43
LINHA 6;;;18;13;13/12/2024;dezembro;31
LINHA 6;;;44;61;13/12/2024;dezembro;105
LINHA 6;;;33;28;13/12/2024;dezembro;61
LINHA 1;;;51;95;13/12/2024;dezembro;146
LINHA 1;;;86;69;13/12/2024;dezembro;155
LINHA 4;;;5;3;13/12/2024;dezembro;8
LINHA 4;;;9;5;13/12/2024;dezembro;14
LINHA 3;;;34;36;13/12/2024;dezembro;70
LINHA 3;;;28;20;13/12/2024;dezembro;48
CIRCULAR - 01;;;38;43;14/12/2024;dezembro;81
CIRCULAR - 01;;;16;14;14/12/2024;dezembro;30
CIRCULAR - 01;;;5;5;14/12/2024;dezembro;10
LINHA 1;;;58;66;14/12/2024;dezembro;124
LINHA 1;;;34;21;14/12/2024;dezembro;55
LINHA 6;;;40;30;14/12/2024;dezembro;70
LINHA 6;;;10;12;14/12/2024;dezembro;22
LINHA 3;;;11;11;14/12/2024;dezembro;22
LINHA 3;;;18;20;14/12/2024;dezembro;38
CIRCULAR - 01;;;14;20;15/12/2024;dezembro;34
CIRCULAR - 01;;;10;16;15/12/2024;dezembro;26
CIRCULAR - 01;;;4;9;15/12/2024;dezembro;13
LINHA 1;;;5;7;15/12/2024;dezembro;12
LINHA 1;;;10;15;15/12/2024;dezembro;25
LINHA 6;;;2;8;15/12/2024;dezembro;10
LINHA 6;;;2;4;15/12/2024;dezembro;6
LINHA 3;;;1;5;15/12/2024;dezembro;6
CIRCULAR - 01;;;77;68;16/12/2024;dezembro;145
CIRCULAR - 01;;;46;46;16/12/2024;dezembro;92
CIRCULAR - 01;;;26;16;16/12/2024;dezembro;42
LINHA 1;;;50;70;16/12/2024;dezembro;120
LINHA 1;;;59;61;16/12/2024;dezembro;120
LINHA 3;;;2;0;16/12/2024;dezembro;2
LINHA 3;;;21;20;16/12/2024;dezembro;41
LINHA 6;;;19;31;16/12/2024;dezembro;50
LINHA 6;;;39;70;16/12/2024;dezembro;109
LINHA 6;;;16;14;16/12/2024;dezembro;30
LINHA 6;;;25;29;17/12/2024;dezembro;54
LINHA 6;;;21;26;17/12/2024;dezembro;47
CIRCULAR - 01;;;74;101;17/12/2024;dezembro;175
CIRCULAR - 01;;;21;29;17/12/2024;dezembro;50
CIRCULAR - 01;;;11;11;17/12/2024;dezembro;22
LINHA 1;;;41;105;17/12/2024;dezembro;146
LINHA 1;;;88;58;17/12/2024;dezembro;146
LINHA 3;;;41;36;17/12/2024;dezembro;77
LINHA 3;;;31;18;17/12/2024;dezembro;49
LINHA 6;;;21;37;17/12/2024;dezembro;58
LINHA 6;;;14;28;17/12/2024;dezembro;42
LINHA 2;;;3;2;18/12/2024;dezembro;5
LINHA 2;;;7;9;18/12/2024;dezembro;16
LINHA 2;;;12;7;18/12/2024;dezembro;19
CIRCULAR - 01;;;52;77;18/12/2024;dezembro;129
CIRCULAR - 01;;;6;26;18/12/2024;dezembro;32
CIRCULAR - 01;;;21;25;18/12/2024;dezembro;46
LINHA 3;;;29;32;18/12/2024;dezembro;61
LINHA 3;;;32;22;18/12/2024;dezembro;54
LINHA 4;;;5;10;18/12/2024;dezembro;15
LINHA 4;;;4;9;18/12/2024;dezembro;13
LINHA 6;;;24;30;18/12/2024;dezembro;54
LINHA 6;;;48;62;18/12/2024;dezembro;110
LINHA 6;;;33;22;18/12/2024;dezembro;55
LINHA 1;;;55;102;18/12/2024;dezembro;157
LINHA 1;;;79;67;18/12/2024;dezembro;146
LINHA 3;;;43;36;19/12/2024;dezembro;79
LINHA 3;;;35;30;19/12/2024;dezembro;65
LINHA 2;;;0;0;19/12/2024;dezembro;0
LINHA 2;;;15;11;19/12/2024;dezembro;26
LINHA 2;;;6;3;19/12/2024;dezembro;9
CIRCULAR - 01;;;61;79;19/12/2024;dezembro;140
CIRCULAR - 01;;;19;23;19/12/2024;dezembro;42
CIRCULAR - 01;;;18;10;19/12/2024;dezembro;28
LINHA 6;;;13;24;19/12/2024;dezembro;37
LINHA 6;;;43;55;19/12/2024;dezembro;98
LINHA 6;;;30;24;19/12/2024;dezembro;54
LINHA 4;;;3;2;19/12/2024;dezembro;5
LINHA 4;;;6;4;19/12/2024;dezembro;10
LINHA 1;;;57;90;19/12/2024;dezembro;147
LINHA 1;;;66;79;19/12/2024;dezembro;145
LINHA 3;;;46;37;20/12/2024;dezembro;83
LINHA 3;;;32;15;20/12/2024;dezembro;47
LINHA 6;;;0;1;20/12/2024;dezembro;1
LINHA 6;;;12;42;20/12/2024;dezembro;54
LINHA 6;;;37;50;20/12/2024;dezembro;87
LINHA 6;;;13;6;20/12/2024;dezembro;19
LINHA 2;;;4;4;20/12/2024;dezembro;8
LINHA 2;;;15;21;20/12/2024;dezembro;36
LINHA 2;;;16;8;20/12/2024;dezembro;24
LINHA 4;;;1;4;20/12/2024;dezembro;5
LINHA 4;;;3;0;20/12/2024;dezembro;3
CIRCULAR - 01;;;56;92;20/12/2024;dezembro;148
CIRCULAR - 01;;;20;11;20/12/2024;dezembro;31
CIRCULAR - 01;;;18;7;20/12/2024;dezembro;25
LINHA 1;;;63;93;20/12/2024;dezembro;156
LINHA 1;;;79;54;20/12/2024;dezembro;133
LINHA 3;;;21;16;21/12/2024;dezembro;37
LINHA 3;;;25;17;21/12/2024;dezembro;42
LINHA 6;;;26;84;21/12/2024;dezembro;110
LINHA 6;;;17;12;21/12/2024;dezembro;29
LINHA 2;;;12;24;21/12/2024;dezembro;36
LINHA 2;;;6;10;21/12/2024;dezembro;16
LINHA 4;;;4;5;21/12/2024;dezembro;9
LINHA 4;;;0;1;21/12/2024;dezembro;1
CIRCULAR - 01;;;17;33;21/12/2024;dezembro;50
CIRCULAR - 01;;;7;11;21/12/2024;dezembro;18
CIRCULAR - 01;;;26;8;21/12/2024;dezembro;34
LINHA 1;;;63;63;21/12/2024;dezembro;126
LINHA 1;;;28;24;21/12/2024;dezembro;52
LINHA 3;;;7;7;22/12/2024;dezembro;14
LINHA 3;;;16;12;22/12/2024;dezembro;28
LINHA 6;;;14;20;22/12/2024;dezembro;34
LINHA 6;;;1;0;22/12/2024;dezembro;1
LINHA 2;;;7;9;22/12/2024;dezembro;16
LINHA 2;;;3;2;22/12/2024;dezembro;5
LINHA 4;;;2;2;22/12/2024;dezembro;4
LINHA 4;;;1;3;22/12/2024;dezembro;4
CIRCULAR - 01;;;15;18;22/12/2024;dezembro;33
CIRCULAR - 01;;;5;6;22/12/2024;dezembro;11
CIRCULAR - 01;;;8;10;22/12/2024;dezembro;18
LINHA 1;;;7;17;22/12/2024;dezembro;24
LINHA 1;;;9;11;22/12/2024;dezembro;20
LINHA 3;;;45;53;23/12/2024;dezembro;98
LINHA 3;;;39;28;23/12/2024;dezembro;67
LINHA 7;;;2;10;23/12/2024;dezembro;12
LINHA 7;;;2;7;23/12/2024;dezembro;9
LINHA 6;;;7;11;23/12/2024;dezembro;18
LINHA 6;;;21;14;23/12/2024;dezembro;35
LINHA 6;;;16;37;23/12/2024;dezembro;53
LINHA 6;;;58;88;23/12/2024;dezembro;146
LINHA 5;;;4;2;23/12/2024;dezembro;6
LINHA 5;;;2;4;23/12/2024;dezembro;6
LINHA 5;;;6;6;23/12/2024;dezembro;12
LINHA 4;;;4;7;23/12/2024;dezembro;11
LINHA 4;;;5;2;23/12/2024;dezembro;7
LINHA 2;;;7;8;23/12/2024;dezembro;15
LINHA 2;;;20;25;23/12/2024;dezembro;45
LINHA 2;;;26;17;23/12/2024;dezembro;43
LINHA 1;;;74;122;23/12/2024;dezembro;196
LINHA 1;;;111;89;23/12/2024;dezembro;200
LINHA 3;;;43;33;24/12/2024;dezembro;76
LINHA 3;;;24;12;24/12/2024;dezembro;36
LINHA 7;;;0;6;24/12/2024;dezembro;6
LINHA 7;;;0;1;24/12/2024;dezembro;1
LINHA 6;;;15;35;24/12/2024;dezembro;50
LINHA 6;;;30;30;24/12/2024;dezembro;60
LINHA 6;;;11;15;24/12/2024;dezembro;26
LINHA 5;;;10;4;24/12/2024;dezembro;14
LINHA 5;;;2;3;24/12/2024;dezembro;5
LINHA 5;;;1;1;24/12/2024;dezembro;2
LINHA 4;;;1;6;24/12/2024;dezembro;7
LINHA 4;;;7;4;24/12/2024;dezembro;11
LINHA 2;;;6;12;24/12/2024;dezembro;18
LINHA 2;;;21;16;24/12/2024;dezembro;37
LINHA 2;;;23;11;24/12/2024;dezembro;34
LINHA 1;;;56;89;24/12/2024;dezembro;145
LINHA 1;;;53;50;24/12/2024;dezembro;103
LINHA 3;;;10;10;25/12/2024;dezembro;20
LINHA 3;;;5;8;25/12/2024;dezembro;13
LINHA 7;;;0;0;25/12/2024;dezembro;0
LINHA 7;;;0;0;25/12/2024;dezembro;0
LINHA 6;;;0;14;25/12/2024;dezembro;14
LINHA 6;;;3;7;25/12/2024;dezembro;10
LINHA 5;;;1;6;25/12/2024;dezembro;7
LINHA 5;;;3;2;25/12/2024;dezembro;5
LINHA 4;;;1;0;25/12/2024;dezembro;1
LINHA 4;;;6;3;25/12/2024;dezembro;9
LINHA 2;;;12;14;25/12/2024;dezembro;26
LINHA 2;;;3;6;25/12/2024;dezembro;9
LINHA 1;;;4;10;25/12/2024;dezembro;14
LINHA 1;;;5;23;25/12/2024;dezembro;28
LINHA 3;;;35;42;26/12/2024;dezembro;77
LINHA 7;;;2;0;26/12/2024;dezembro;2
LINHA 3;;;23;13;26/12/2024;dezembro;36
LINHA 7;;;6;2;26/12/2024;dezembro;8
LINHA 6;;;17;33;26/12/2024;dezembro;50
LINHA 6;;;7;26;26/12/2024;dezembro;33
LINHA 6;;;25;28;26/12/2024;dezembro;53
LINHA 6;;;14;15;26/12/2024;dezembro;29
LINHA 7;;;0;0;26/12/2024;dezembro;0
LINHA 5;;;8;2;26/12/2024;dezembro;10
LINHA 5;;;3;5;26/12/2024;dezembro;8
LINHA 5;;;4;2;26/12/2024;dezembro;6
LINHA 4;;;1;7;26/12/2024;dezembro;8
LINHA 4;;;4;4;26/12/2024;dezembro;8
LINHA 2;;;0;7;26/12/2024;dezembro;7
LINHA 2;;;14;27;26/12/2024;dezembro;41
LINHA 2;;;18;10;26/12/2024;dezembro;28
LINHA 1;;;39;123;26/12/2024;dezembro;162
LINHA 1;;;54;38;26/12/2024;dezembro;92
LINHA 3;;;42;32;27/12/2024;dezembro;74
LINHA 3;;;30;26;27/12/2024;dezembro;56
LINHA 7;;;2;1;27/12/2024;dezembro;3
LINHA 6;;;19;58;27/12/2024;dezembro;77
LINHA 6;;;40;70;27/12/2024;dezembro;110
LINHA 6;;;25;12;27/12/2024;dezembro;37
LINHA 7;;;3;5;27/12/2024;dezembro;8
LINHA 7;;;0;0;27/12/2024;dezembro;0
LINHA 5;;;5;13;27/12/2024;dezembro;18
LINHA 5;;;5;2;27/12/2024;dezembro;7
LINHA 5;;;7;1;27/12/2024;dezembro;8
LINHA 4;;;2;9;27/12/2024;dezembro;11
LINHA 4;;;8;2;27/12/2024;dezembro;10
LINHA 2;;;6;10;27/12/2024;dezembro;16
LINHA 2;;;18;28;27/12/2024;dezembro;46
LINHA 2;;;18;14;27/12/2024;dezembro;32
LINHA 1;;;68;104;27/12/2024;dezembro;172
LINHA 1;;;80;64;27/12/2024;dezembro;144
LINHA 3;;;17;16;28/12/2024;dezembro;33
LINHA 3;;;28;25;28/12/2024;dezembro;53
LINHA 7;;;1;2;28/12/2024;dezembro;3
LINHA 7;;;0;0;28/12/2024;dezembro;0
LINHA 6;;;25;64;28/12/2024;dezembro;89
LINHA 6;;;12;14;28/12/2024;dezembro;26
LINHA 5;;;1;4;28/12/2024;dezembro;5
LINHA 5;;;5;8;28/12/2024;dezembro;13
LINHA 4;;;4;5;28/12/2024;dezembro;9
LINHA 4;;;0;4;28/12/2024;dezembro;4
LINHA 2;;;22;17;28/12/2024;dezembro;39
LINHA 2;;;7;6;28/12/2024;dezembro;13
LINHA 1;;;65;108;28/12/2024;dezembro;173
LINHA 1;;;23;15;28/12/2024;dezembro;38
LINHA 3;;;5;14;29/12/2024;dezembro;19
LINHA 3;;;5;12;29/12/2024;dezembro;17
LINHA 7;;;1;0;29/12/2024;dezembro;1
LINHA 7;;;0;0;29/12/2024;dezembro;0
LINHA 6;;;4;17;29/12/2024;dezembro;21
LINHA 6;;;16;19;29/12/2024;dezembro;35
LINHA 5;;;0;0;29/12/2024;dezembro;0
LINHA 5;;;0;3;29/12/2024;dezembro;3
LINHA 4;;;3;4;29/12/2024;dezembro;7
LINHA 4;;;4;4;29/12/2024;dezembro;8
LINHA 2;;;8;9;29/12/2024;dezembro;17
LINHA 2;;;2;7;29/12/2024;dezembro;9
LINHA 1;;;14;16;29/12/2024;dezembro;30
LINHA 1;;;10;21;29/12/2024;dezembro;31
LINHA 3;;;50;53;30/12/2024;dezembro;103
LINHA 3;;;32;23;30/12/2024;dezembro;55
LINHA 7;;;2;6;30/12/2024;dezembro;8
LINHA 7;;;1;2;30/12/2024;dezembro;3
LINHA 6;;;25;42;30/12/2024;dezembro;67
LINHA 6;;;42;81;30/12/2024;dezembro;123
LINHA 6;;;34;24;30/12/2024;dezembro;58
LINHA 5;;;12;11;30/12/2024;dezembro;23
LINHA 5;;;0;0;30/12/2024;dezembro;0
LINHA 7;;;0;0;30/12/2024;dezembro;0
LINHA 7;;;0;4;30/12/2024;dezembro;4
LINHA 5;;;0;0;30/12/2024;dezembro;0
LINHA 5;;;5;12;30/12/2024;dezembro;17
LINHA 5;;;3;8;30/12/2024;dezembro;11
LINHA 4;;;5;15;30/12/2024;dezembro;20
LINHA 4;;;4;5;30/12/2024;dezembro;9
LINHA 2;;;8;14;30/12/2024;dezembro;22
LINHA 2;;;26;48;30/12/2024;dezembro;74
LINHA 2;;;20;12;30/12/2024;dezembro;32
LINHA 1;;;45;130;30/12/2024;dezembro;175
LINHA 1;;;86;78;30/12/2024;dezembro;164
LINHA 3;;;45;28;31/12/2024;dezembro;73
LINHA 3;;;26;17;31/12/2024;dezembro;43
LINHA 6;;;16;51;31/12/2024;dezembro;67
LINHA 6;;;34;56;31/12/2024;dezembro;90
LINHA 6;;;15;13;31/12/2024;dezembro;28
LINHA 7;;;2;5;31/12/2024;dezembro;7
LINHA 7;;;0;2;31/12/2024;dezembro;2
LINHA 7;;;0;0;31/12/2024;dezembro;0
LINHA 7;;;2;0;31/12/2024;dezembro;2
LINHA 5;;;8;10;31/12/2024;dezembro;18
LINHA 5;;;2;2;31/12/2024;dezembro;4
LINHA 5;;;1;1;31/12/2024;dezembro;2
LINHA 4;;;6;12;31/12/2024;dezembro;18
LINHA 4;;;2;8;31/12/2024;dezembro;10
LINHA 2;;;9;15;31/12/2024;dezembro;24
LINHA 2;;;36;22;31/12/2024;dezembro;58
LINHA 2;;;6;6;31/12/2024;dezembro;12
LINHA 1;;;58;115;31/12/2024;dezembro;173
LINHA 1;;;48;31;31/12/2024;dezembro;79
LINHA 3;;;6;8;01/01/2025;janeiro;14
LINHA 3;;;5;5;01/01/2025;janeiro;10
LINHA 6;;;1;11;01/01/2025;janeiro;12
LINHA 6;;;2;4;01/01/2025;janeiro;6
LINHA 6;;;1;3;01/01/2025;janeiro;4
LINHA 7;;;0;0;01/01/2025;janeiro;0
LINHA 7;;;0;0;01/01/2025;janeiro;0
LINHA 7;;;0;0;01/01/2025;janeiro;0
LINHA 5;;;0;3;01/01/2025;janeiro;3
LINHA 5;;;1;3;01/01/2025;janeiro;4
LINHA 4;;;0;1;01/01/2025;janeiro;1
LINHA 4;;;2;5;01/01/2025;janeiro;7
LINHA 2;;;16;14;01/01/2025;janeiro;30
LINHA 2;;;0;4;01/01/2025;janeiro;4
LINHA 1;;;5;12;01/01/2025;janeiro;17
LINHA 1;;;10;25;01/01/2025;janeiro;35
LINHA 3;;;53;52;02/01/2025;janeiro;105
LINHA 3;;;27;23;02/01/2025;janeiro;50
LINHA 2;;;9;18;02/01/2025;janeiro;27
LINHA 2;;;24;38;02/01/2025;janeiro;62
LINHA 2;;;25;19;02/01/2025;janeiro;44
LINHA 6;;;21;65;02/01/2025;janeiro;86
LINHA 6;;;40;73;02/01/2025;janeiro;113
LINHA 6;;;21;13;02/01/2025;janeiro;34
LINHA 7;;;2;4;02/01/2025;janeiro;6
LINHA 7;;;1;3;02/01/2025;janeiro;4
LINHA 7;;;1;0;02/01/2025;janeiro;1
LINHA 5;;;9;17;02/01/2025;janeiro;26
LINHA 5;;;1;4;02/01/2025;janeiro;5
LINHA 5;;;2;5;02/01/2025;janeiro;7
LINHA 4;;;6;13;02/01/2025;janeiro;19
LINHA 4;;;4;10;02/01/2025;janeiro;14
LINHA 1;;;52;121;02/01/2025;janeiro;173
LINHA 1;;;72;58;02/01/2025;janeiro;130
LINHA 3;;;60;67;03/01/2025;janeiro;127
LINHA 3;;;27;22;03/01/2025;janeiro;49
LINHA 2;;;13;22;03/01/2025;janeiro;35
LINHA 2;;;36;38;03/01/2025;janeiro;74
LINHA 2;;;24;13;03/01/2025;janeiro;37
LINHA 6;;;28;41;03/01/2025;janeiro;69
LINHA 6;;;39;91;03/01/2025;janeiro;130
LINHA 6;;;19;20;03/01/2025;janeiro;39
LINHA 7;;;0;4;03/01/2025;janeiro;4
LINHA 7;;;1;6;03/01/2025;janeiro;7
LINHA 7;;;0;0;03/01/2025;janeiro;0
LINHA 5;;;3;4;03/01/2025;janeiro;7
LINHA 5;;;2;10;03/01/2025;janeiro;12
LINHA 5;;;1;10;03/01/2025;janeiro;11
LINHA 5;;;3;4;03/01/2025;janeiro;7
LINHA 4;;;4;14;03/01/2025;janeiro;18
LINHA 4;;;6;5;03/01/2025;janeiro;11
LINHA 1;;;62;138;03/01/2025;janeiro;200
LINHA 1;;;83;76;03/01/2025;janeiro;159
LINHA 3;;;28;24;04/01/2025;janeiro;52
LINHA 3;;;9;8;04/01/2025;janeiro;17
LINHA 5;;;5;4;04/01/2025;janeiro;9
LINHA 5;;;3;2;04/01/2025;janeiro;5
LINHA 4;;;37;68;04/01/2025;janeiro;105
LINHA 4;;;14;12;04/01/2025;janeiro;26
LINHA 7;;;1;0;04/01/2025;janeiro;1
LINHA 7;;;0;1;04/01/2025;janeiro;1
LINHA 7;;;2;1;04/01/2025;janeiro;3
LINHA 2;;;15;9;04/01/2025;janeiro;24
LINHA 2;;;16;11;04/01/2025;janeiro;27
LINHA 4;;;6;8;04/01/2025;janeiro;14
LINHA 4;;;2;2;04/01/2025;janeiro;4
LINHA 1;;;41;93;04/01/2025;janeiro;134
LINHA 1;;;28;20;04/01/2025;janeiro;48
LINHA 3;;;7;9;05/01/2025;janeiro;16
LINHA 3;;;5;8;05/01/2025;janeiro;13
LINHA 5;;;1;1;05/01/2025;janeiro;2
LINHA 5;;;3;3;05/01/2025;janeiro;6
LINHA 6;;;4;26;05/01/2025;janeiro;30
LINHA 6;;;6;14;05/01/2025;janeiro;20
LINHA 7;;;0;6;05/01/2025;janeiro;6
LINHA 7;;;0;1;05/01/2025;janeiro;1
LINHA 2;;;11;15;05/01/2025;janeiro;26
LINHA 2;;;6;8;05/01/2025;janeiro;14
LINHA 4;;;0;4;05/01/2025;janeiro;4
LINHA 4;;;4;6;05/01/2025;janeiro;10
LINHA 1;;;16;32;05/01/2025;janeiro;48
LINHA 1;;;4;19;05/01/2025;janeiro;23
LINHA 3;;;59;50;06/01/2025;janeiro;109
LINHA 3;;;47;33;06/01/2025;janeiro;80
LINHA 5;;;5;24;06/01/2025;janeiro;29
LINHA 5;;;5;13;06/01/2025;janeiro;18
LINHA 5;;;5;6;06/01/2025;janeiro;11
LINHA 6;;;28;74;06/01/2025;janeiro;102
LINHA 6;;;52;91;06/01/2025;janeiro;143
LINHA 6;;;36;31;06/01/2025;janeiro;67
LINHA 7;;;5;6;06/01/2025;janeiro;11
LINHA 7;;;5;1;06/01/2025;janeiro;6
LINHA 7;;;0;1;06/01/2025;janeiro;1
LINHA 2;;;12;12;06/01/2025;janeiro;24
LINHA 2;;;28;42;06/01/2025;janeiro;70
LINHA 2;;;5;9;06/01/2025;janeiro;14
LINHA 2;;;22;19;06/01/2025;janeiro;41
LINHA 4;;;10;11;06/01/2025;janeiro;21
LINHA 4;;;10;7;06/01/2025;janeiro;17
LINHA 1;;;73;122;06/01/2025;janeiro;195
LINHA 1;;;90;86;06/01/2025;janeiro;176
LINHA 3;;;50;28;07/01/2025;janeiro;78
LINHA 5;;;9;20;07/01/2025;janeiro;29
LINHA 5;;;5;1;07/01/2025;janeiro;6
LINHA 5;;;7;3;07/01/2025;janeiro;10
LINHA 6;;;17;61;07/01/2025;janeiro;78
LINHA 6;;;39;101;07/01/2025;janeiro;140
LINHA 6;;;24;17;07/01/2025;janeiro;41
LINHA 3;;;21;21;07/01/2025;janeiro;42
LINHA 3;;;38;34;07/01/2025;janeiro;72
LINHA 7;;;6;3;07/01/2025;janeiro;9
LINHA 7;;;1;2;07/01/2025;janeiro;3
LINHA 7;;;1;1;07/01/2025;janeiro;2
LINHA 2;;;2;4;07/01/2025;janeiro;6
LINHA 2;;;30;40;07/01/2025;janeiro;70
LINHA 2;;;28;25;07/01/2025;janeiro;53
LINHA 4;;;4;12;07/01/2025;janeiro;16
LINHA 4;;;13;6;07/01/2025;janeiro;19
LINHA 1;;;74;164;07/01/2025;janeiro;238
LINHA 1;;;76;75;07/01/2025;janeiro;151
LINHA 2;;;7;13;08/01/2025;janeiro;20
LINHA 2;;;21;43;08/01/2025;janeiro;64
LINHA 2;;;36;24;08/01/2025;janeiro;60
LINHA 5;;;17;13;08/01/2025;janeiro;30
LINHA 5;;;5;7;08/01/2025;janeiro;12
LINHA 5;;;7;5;08/01/2025;janeiro;12
LINHA 6;;;34;61;08/01/2025;janeiro;95
LINHA 6;;;48;93;08/01/2025;janeiro;141
LINHA 6;;;27;25;08/01/2025;janeiro;52
LINHA 3;;;75;43;08/01/2025;janeiro;118
LINHA 3;;;38;25;08/01/2025;janeiro;63
LINHA 7;;;3;0;08/01/2025;janeiro;3
LINHA 4;;;2;9;08/01/2025;janeiro;11
LINHA 4;;;11;3;08/01/2025;janeiro;14
LINHA 7;;;6;6;08/01/2025;janeiro;12
LINHA 7;;;2;4;08/01/2025;janeiro;6
LINHA 7;;;0;0;08/01/2025;janeiro;0
LINHA 1;;;68;138;08/01/2025;janeiro;206
LINHA 1;;;83;72;08/01/2025;janeiro;155
LINHA 3;;;60;42;09/01/2025;janeiro;102
LINHA 3;;;46;25;09/01/2025;janeiro;71
LINHA 5;;;12;13;09/01/2025;janeiro;25
LINHA 5;;;4;9;09/01/2025;janeiro;13
LINHA 5;;;7;4;09/01/2025;janeiro;11
LINHA 6;;;32;33;09/01/2025;janeiro;65
LINHA 6;;;31;79;09/01/2025;janeiro;110
LINHA 6;;;24;16;09/01/2025;janeiro;40
LINHA 7;;;4;4;09/01/2025;janeiro;8
LINHA 7;;;0;2;09/01/2025;janeiro;2
LINHA 7;;;0;0;09/01/2025;janeiro;0
LINHA 4;;;4;9;09/01/2025;janeiro;13
LINHA 4;;;1;2;09/01/2025;janeiro;3
LINHA 2;;;6;7;09/01/2025;janeiro;13
LINHA 2;;;35;25;09/01/2025;janeiro;60
LINHA 2;;;12;18;09/01/2025;janeiro;30
LINHA 1;;;80;131;09/01/2025;janeiro;211
LINHA 1;;;75;68;09/01/2025;janeiro;143
LINHA 3;;;71;56;10/01/2025;janeiro;127
LINHA 3;;;35;28;10/01/2025;janeiro;63
LINHA 5;;;11;16;10/01/2025;janeiro;27
LINHA 5;;;2;10;10/01/2025;janeiro;12
LINHA 5;;;5;2;10/01/2025;janeiro;7
LINHA 6;;;30;47;10/01/2025;janeiro;77
LINHA 6;;;52;83;10/01/2025;janeiro;135
LINHA 6;;;30;17;10/01/2025;janeiro;47
LINHA 7;;;3;4;10/01/2025;janeiro;7
LINHA 7;;;3;7;10/01/2025;janeiro;10
LINHA 7;;;5;1;10/01/2025;janeiro;6
LINHA 4;;;15;9;10/01/2025;janeiro;24
LINHA 4;;;13;6;10/01/2025;janeiro;19
LINHA 2;;;7;18;10/01/2025;janeiro;25
LINHA 2;;;24;43;10/01/2025;janeiro;67
LINHA 2;;;31;16;10/01/2025;janeiro;47
LINHA 1;;;83;141;10/01/2025;janeiro;224
LINHA 1;;;107;93;10/01/2025;janeiro;200
LINHA 3;;;20;23;11/01/2025;janeiro;43
LINHA 3;;;19;9;11/01/2025;janeiro;28
LINHA 5;;;8;7;11/01/2025;janeiro;15
LINHA 5;;;5;5;11/01/2025;janeiro;10
LINHA 6;;;35;66;11/01/2025;janeiro;101
LINHA 6;;;18;28;11/01/2025;janeiro;46
LINHA 7;;;3;4;11/01/2025;janeiro;7
LINHA 7;;;1;3;11/01/2025;janeiro;4
LINHA 7;;;1;1;11/01/2025;janeiro;2
LINHA 4;;;2;4;11/01/2025;janeiro;6
LINHA 4;;;5;3;11/01/2025;janeiro;8
LINHA 2;;;14;7;11/01/2025;janeiro;21
LINHA 2;;;11;6;11/01/2025;janeiro;17
LINHA 1;;;67;73;11/01/2025;janeiro;140
LINHA 1;;;34;50;11/01/2025;janeiro;84
LINHA 3;;;9;7;12/01/2025;janeiro;16
LINHA 3;;;4;9;12/01/2025;janeiro;13
LINHA 5;;;1;0;12/01/2025;janeiro;1
LINHA 5;;;3;2;12/01/2025;janeiro;5
LINHA 6;;;7;24;12/01/2025;janeiro;31
LINHA 6;;;12;13;12/01/2025;janeiro;25
LINHA 7;;;3;1;12/01/2025;janeiro;4
LINHA 7;;;0;0;12/01/2025;janeiro;0
LINHA 4;;;0;1;12/01/2025;janeiro;1
LINHA 4;;;3;4;12/01/2025;janeiro;7
LINHA 2;;;5;3;12/01/2025;janeiro;8
LINHA 2;;;2;3;12/01/2025;janeiro;5
LINHA 1;;;11;37;12/01/2025;janeiro;48
LINHA 1;;;11;8;12/01/2025;janeiro;19
LINHA 3;;;57;54;13/01/2025;janeiro;111
LINHA 3;;;29;45;13/01/2025;janeiro;74
LINHA 5;;;11;9;13/01/2025;janeiro;20
LINHA 5;;;3;6;13/01/2025;janeiro;9
LINHA 5;;;3;9;13/01/2025;janeiro;12
LINHA 6;;;22;56;13/01/2025;janeiro;78
LINHA 6;;;34;85;13/01/2025;janeiro;119
LINHA 6;;;24;19;13/01/2025;janeiro;43
LINHA 6;;;6;5;13/01/2025;janeiro;11
LINHA 6;;;1;6;13/01/2025;janeiro;7
LINHA 6;;;0;0;13/01/2025;janeiro;0
LINHA 2;;;16;5;13/01/2025;janeiro;21
LINHA 4;;;3;12;13/01/2025;janeiro;15
LINHA 2;;;7;3;13/01/2025;janeiro;10
LINHA 2;;;8;23;13/01/2025;janeiro;31
LINHA 2;;;5;4;13/01/2025;janeiro;9
LINHA 4;;;3;3;13/01/2025;janeiro;6
LINHA 1;;;63;131;13/01/2025;janeiro;194
LINHA 1;;;93;111;13/01/2025;janeiro;204
LINHA 3;;;18;34;14/01/2025;janeiro;52
LINHA 3;;;34;33;14/01/2025;janeiro;67
LINHA 5;;;8;21;14/01/2025;janeiro;29
LINHA 5;;;6;9;14/01/2025;janeiro;15
LINHA 5;;;6;5;14/01/2025;janeiro;11
LINHA 7;;;1;8;14/01/2025;janeiro;9
LINHA 7;;;0;2;14/01/2025;janeiro;2
LINHA 7;;;2;0;14/01/2025;janeiro;2
LINHA 6;;;17;37;14/01/2025;janeiro;54
LINHA 6;;;69;63;14/01/2025;janeiro;132
LINHA 6;;;13;11;14/01/2025;janeiro;24
LINHA 2;;;4;1;14/01/2025;janeiro;5
LINHA 2;;;14;17;14/01/2025;janeiro;31
LINHA 2;;;14;6;14/01/2025;janeiro;20
LINHA 4;;;7;12;14/01/2025;janeiro;19
LINHA 4;;;13;13;14/01/2025;janeiro;26
LINHA 1;;;69;120;14/01/2025;janeiro;189
LINHA 1;;;78;99;14/01/2025;janeiro;177
LINHA 3;;;52;46;15/01/2025;janeiro;98
LINHA 3;;;38;29;15/01/2025;janeiro;67
LINHA 5;;;4;15;15/01/2025;janeiro;19
LINHA 5;;;9;5;15/01/2025;janeiro;14
LINHA 5;;;4;9;15/01/2025;janeiro;13
LINHA 7;;;3;6;15/01/2025;janeiro;9
LINHA 7;;;0;4;15/01/2025;janeiro;4
LINHA 7;;;0;3;15/01/2025;janeiro;3
LINHA 6;;;28;43;15/01/2025;janeiro;71
LINHA 6;;;42;75;15/01/2025;janeiro;117
LINHA 6;;;25;19;15/01/2025;janeiro;44
LINHA 2;;;5;5;15/01/2025;janeiro;10
LINHA 2;;;11;23;15/01/2025;janeiro;34
LINHA 2;;;13;9;15/01/2025;janeiro;22
LINHA 4;;;9;6;15/01/2025;janeiro;15
LINHA 4;;;11;6;15/01/2025;janeiro;17
LINHA 1;;;53;103;15/01/2025;janeiro;156
LINHA 1;;;89;84;15/01/2025;janeiro;173
LINHA 3;;;49;54;16/01/2025;janeiro;103
LINHA 3;;;39;30;16/01/2025;janeiro;69
LINHA 2;;;4;1;16/01/2025;janeiro;5
LINHA 2;;;15;5;16/01/2025;janeiro;20
LINHA 5;;;4;14;16/01/2025;janeiro;18
LINHA 5;;;6;2;16/01/2025;janeiro;8
LINHA 5;;;4;2;16/01/2025;janeiro;6
LINHA 7;;;4;12;16/01/2025;janeiro;16
LINHA 7;;;2;4;16/01/2025;janeiro;6
LINHA 7;;;0;0;16/01/2025;janeiro;0
LINHA 6;;;23;42;16/01/2025;janeiro;65
LINHA 6;;;31;75;16/01/2025;janeiro;106
LINHA 6;;;24;14;16/01/2025;janeiro;38
LINHA 2;;;7;2;16/01/2025;janeiro;9
LINHA 2;;;3;16;16/01/2025;janeiro;19
LINHA 4;;;1;4;16/01/2025;janeiro;5
LINHA 4;;;6;9;16/01/2025;janeiro;15
LINHA 4;;;3;5;16/01/2025;janeiro;8
LINHA 1;;;56;104;16/01/2025;janeiro;160
LINHA 1;;;72;91;16/01/2025;janeiro;163
LINHA 3;;;63;37;17/01/2025;janeiro;100
LINHA 3;;;37;31;17/01/2025;janeiro;68
LINHA 2;;;3;4;17/01/2025;janeiro;7
LINHA 2;;;21;24;17/01/2025;janeiro;45
LINHA 2;;;18;7;17/01/2025;janeiro;25
LINHA 5;;;4;6;17/01/2025;janeiro;10
LINHA 7;;;4;2;17/01/2025;janeiro;6
LINHA 7;;;5;0;17/01/2025;janeiro;5
LINHA 7;;;0;2;17/01/2025;janeiro;2
LINHA 6;;;22;46;17/01/2025;janeiro;68
LINHA 6;;;36;47;17/01/2025;janeiro;83
LINHA 6;;;9;7;17/01/2025;janeiro;16
LINHA 6;;;24;17;17/01/2025;janeiro;41
LINHA 4;;;5;10;17/01/2025;janeiro;15
LINHA 4;;;6;8;17/01/2025;janeiro;14
LINHA 5;;;9;9;17/01/2025;janeiro;18
LINHA 5;;;3;4;17/01/2025;janeiro;7
LINHA 5;;;0;2;17/01/2025;janeiro;2
LINHA 5;;;5;15;17/01/2025;janeiro;20
LINHA 1;;;56;114;17/01/2025;janeiro;170
LINHA 1;;;87;90;17/01/2025;janeiro;177
LINHA 3;;;31;23;18/01/2025;janeiro;54
LINHA 3;;;25;12;18/01/2025;janeiro;37
LINHA 7;;;2;5;18/01/2025;janeiro;7
LINHA 7;;;1;6;18/01/2025;janeiro;7
LINHA 6;;;45;67;18/01/2025;janeiro;112
LINHA 6;;;23;21;18/01/2025;janeiro;44
LINHA 4;;;5;4;18/01/2025;janeiro;9
LINHA 4;;;3;2;18/01/2025;janeiro;5
LINHA 2;;;17;9;18/01/2025;janeiro;26
LINHA 2;;;15;5;18/01/2025;janeiro;20
LINHA 5;;;3;8;18/01/2025;janeiro;11
LINHA 5;;;3;5;18/01/2025;janeiro;8
LINHA 1;;;54;98;18/01/2025;janeiro;152
LINHA 1;;;27;41;18/01/2025;janeiro;68
LINHA 7;;;0;1;19/01/2025;janeiro;1
LINHA 7;;;0;0;19/01/2025;janeiro;0
LINHA 3;;;11;8;19/01/2025;janeiro;19
LINHA 3;;;3;5;19/01/2025;janeiro;8
LINHA 6;;;5;29;19/01/2025;janeiro;34
LINHA 6;;;1;5;19/01/2025;janeiro;6
LINHA 4;;;3;2;19/01/2025;janeiro;5
LINHA 4;;;2;1;19/01/2025;janeiro;3
LINHA 2;;;5;3;19/01/2025;janeiro;8
LINHA 2;;;6;6;19/01/2025;janeiro;12
LINHA 5;;;2;3;19/01/2025;janeiro;5
LINHA 5;;;1;2;19/01/2025;janeiro;3
LINHA 1;;;13;39;19/01/2025;janeiro;52
LINHA 1;;;8;14;19/01/2025;janeiro;22
LINHA 7;;;2;1;20/01/2025;janeiro;3
LINHA 7;;;1;1;20/01/2025;janeiro;2
LINHA 7;;;0;0;20/01/2025;janeiro;0
LINHA 3;;;53;59;20/01/2025;janeiro;112
LINHA 3;;;42;28;20/01/2025;janeiro;70
LINHA 6;;;32;64;20/01/2025;janeiro;96
LINHA 6;;;29;71;20/01/2025;janeiro;100
LINHA 6;;;29;18;20/01/2025;janeiro;47
LINHA 4;;;0;7;20/01/2025;janeiro;7
LINHA 4;;;14;6;20/01/2025;janeiro;20
LINHA 2;;;4;6;20/01/2025;janeiro;10
LINHA 2;;;20;23;20/01/2025;janeiro;43
LINHA 2;;;17;8;20/01/2025;janeiro;25
LINHA 5;;;8;12;20/01/2025;janeiro;20
LINHA 5;;;1;4;20/01/2025;janeiro;5
LINHA 5;;;6;12;20/01/2025;janeiro;18
LINHA 1;;;73;116;20/01/2025;janeiro;189
LINHA 1;;;80;74;20/01/2025;janeiro;154
LINHA 7;;;1;5;21/01/2025;janeiro;6
LINHA 7;;;2;3;21/01/2025;janeiro;5
LINHA 7;;;0;0;21/01/2025;janeiro;0
LINHA 3;;;54;59;21/01/2025;janeiro;113
LINHA 3;;;40;42;21/01/2025;janeiro;82
LINHA 6;;;35;38;21/01/2025;janeiro;73
LINHA 6;;;49;53;21/01/2025;janeiro;102
LINHA 6;;;22;19;21/01/2025;janeiro;41
LINHA 4;;;3;13;21/01/2025;janeiro;16
LINHA 4;;;16;6;21/01/2025;janeiro;22
LINHA 2;;;6;2;21/01/2025;janeiro;8
LINHA 2;;;12;19;21/01/2025;janeiro;31
LINHA 2;;;16;8;21/01/2025;janeiro;24
LINHA 5;;;12;16;21/01/2025;janeiro;28
LINHA 5;;;8;3;21/01/2025;janeiro;11
LINHA 5;;;2;6;21/01/2025;janeiro;8
LINHA 1;;;68;103;21/01/2025;janeiro;171
LINHA 1;;;85;78;21/01/2025;janeiro;163
LINHA 2;;;9;7;22/01/2025;janeiro;16
LINHA 2;;;9;23;22/01/2025;janeiro;32
LINHA 1;;;8;14;22/01/2025;janeiro;22
LINHA 1;;;67;66;22/01/2025;janeiro;133
LINHA 6;;;0;1;22/01/2025;janeiro;1
LINHA 1;;;14;15;22/01/2025;janeiro;29
LINHA 7;;;0;2;22/01/2025;janeiro;2
LINHA 3;;;58;55;22/01/2025;janeiro;113
LINHA 3;;;45;39;22/01/2025;janeiro;84
LINHA 5;;;11;16;22/01/2025;janeiro;27
LINHA 5;;;5;4;22/01/2025;janeiro;9
LINHA 5;;;5;8;22/01/2025;janeiro;13
LINHA 6;;;35;53;22/01/2025;janeiro;88
LINHA 6;;;41;61;22/01/2025;janeiro;102
LINHA 6;;;34;26;22/01/2025;janeiro;60
LINHA 4;;;24;11;22/01/2025;janeiro;35
LINHA 4;;;12;5;22/01/2025;janeiro;17
LINHA 2;;;5;7;22/01/2025;janeiro;12
LINHA 2;;;22;7;22/01/2025;janeiro;29
LINHA 1;;;46;89;22/01/2025;janeiro;135
LINHA 7;;;14;6;22/01/2025;janeiro;20
LINHA 7;;;1;0;22/01/2025;janeiro;1
LINHA 7;;;0;0;22/01/2025;janeiro;0
LINHA 6;;;2;0;23/01/2025;janeiro;2
LINHA 5;;;15;15;23/01/2025;janeiro;30
LINHA 5;;;5;5;23/01/2025;janeiro;10
LINHA 5;;;8;3;23/01/2025;janeiro;11
LINHA 3;;;63;81;23/01/2025;janeiro;144
LINHA 3;;;29;39;23/01/2025;janeiro;68
LINHA 6;;;12;32;23/01/2025;janeiro;44
LINHA 6;;;27;72;23/01/2025;janeiro;99
LINHA 6;;;26;34;23/01/2025;janeiro;60
LINHA 4;;;8;6;23/01/2025;janeiro;14
LINHA 4;;;8;8;23/01/2025;janeiro;16
LINHA 2;;;6;6;23/01/2025;janeiro;12
LINHA 2;;;13;22;23/01/2025;janeiro;35
LINHA 2;;;21;16;23/01/2025;janeiro;37
LINHA 1;;;75;89;23/01/2025;janeiro;164
LINHA 1;;;64;88;23/01/2025;janeiro;152
LINHA 7;;;1;8;23/01/2025;janeiro;9
LINHA 7;;;1;5;23/01/2025;janeiro;6
LINHA 7;;;0;1;23/01/2025;janeiro;1
LINHA 2;;;7;7;24/01/2025;janeiro;14
LINHA 2;;;10;14;24/01/2025;janeiro;24
LINHA 2;;;19;13;24/01/2025;janeiro;32
LINHA 5;;;8;13;24/01/2025;janeiro;21
LINHA 5;;;3;14;24/01/2025;janeiro;17
LINHA 5;;;7;4;24/01/2025;janeiro;11
LINHA 3;;;70;63;24/01/2025;janeiro;133
LINHA 3;;;42;25;24/01/2025;janeiro;67
LINHA 6;;;26;54;24/01/2025;janeiro;80
LINHA 6;;;24;70;24/01/2025;janeiro;94
LINHA 6;;;36;31;24/01/2025;janeiro;67
LINHA 4;;;9;11;24/01/2025;janeiro;20
LINHA 4;;;6;7;24/01/2025;janeiro;13
LINHA 1;;;69;112;24/01/2025;janeiro;181
LINHA 1;;;92;90;24/01/2025;janeiro;182
LINHA 7;;;8;11;24/01/2025;janeiro;19
LINHA 7;;;0;2;24/01/2025;janeiro;2
LINHA 7;;;0;1;24/01/2025;janeiro;1
LINHA 2;;;22;12;25/01/2025;janeiro;34
LINHA 2;;;8;6;25/01/2025;janeiro;14
LINHA 5;;;7;9;25/01/2025;janeiro;16
LINHA 5;;;3;8;25/01/2025;janeiro;11
LINHA 3;;;22;32;25/01/2025;janeiro;54
LINHA 3;;;7;9;25/01/2025;janeiro;16
LINHA 6;;;49;72;25/01/2025;janeiro;121
LINHA 6;;;18;12;25/01/2025;janeiro;30
LINHA 4;;;6;3;25/01/2025;janeiro;9
LINHA 4;;;2;3;25/01/2025;janeiro;5
LINHA 1;;;55;88;25/01/2025;janeiro;143
LINHA 1;;;29;20;25/01/2025;janeiro;49
LINHA 7;;;0;0;25/01/2025;janeiro;0
LINHA 7;;;2;0;25/01/2025;janeiro;2
LINHA 2;;;1;2;26/01/2025;janeiro;3
LINHA 5;;;2;3;26/01/2025;janeiro;5
LINHA 5;;;4;3;26/01/2025;janeiro;7
LINHA 3;;;11;15;26/01/2025;janeiro;26
LINHA 3;;;4;24;26/01/2025;janeiro;28
LINHA 6;;;3;20;26/01/2025;janeiro;23
LINHA 6;;;6;12;26/01/2025;janeiro;18
LINHA 4;;;2;3;26/01/2025;janeiro;5
LINHA 4;;;1;4;26/01/2025;janeiro;5
LINHA 2;;;4;5;26/01/2025;janeiro;9
LINHA 2;;;0;5;26/01/2025;janeiro;5
LINHA 1;;;18;39;26/01/2025;janeiro;57
LINHA 1;;;3;15;26/01/2025;janeiro;18
LINHA 7;;;4;0;26/01/2025;janeiro;4
LINHA 7;;;1;0;26/01/2025;janeiro;1
LINHA 2;;;20;8;27/01/2025;janeiro;28
LINHA 5;;;4;18;27/01/2025;janeiro;22
LINHA 5;;;4;3;27/01/2025;janeiro;7
LINHA 5;;;7;7;27/01/2025;janeiro;14
LINHA 3;;;69;72;27/01/2025;janeiro;141
LINHA 3;;;48;36;27/01/2025;janeiro;84
LINHA 6;;;34;44;27/01/2025;janeiro;78
LINHA 6;;;54;77;27/01/2025;janeiro;131
LINHA 6;;;21;15;27/01/2025;janeiro;36
LINHA 4;;;10;11;27/01/2025;janeiro;21
LINHA 4;;;13;1;27/01/2025;janeiro;14
LINHA 2;;;8;2;27/01/2025;janeiro;10
LINHA 2;;;12;14;27/01/2025;janeiro;26
LINHA 1;;;83;116;27/01/2025;janeiro;199
LINHA 1;;;88;77;27/01/2025;janeiro;165
LINHA 7;;;1;3;27/01/2025;janeiro;4
LINHA 7;;;0;3;27/01/2025;janeiro;3
LINHA 7;;;0;0;27/01/2025;janeiro;0
LINHA 2;;;4;4;28/01/2025;janeiro;8
LINHA 2;;;1;1;28/01/2025;janeiro;2
LINHA 5;;;11;15;28/01/2025;janeiro;26
LINHA 5;;;8;6;28/01/2025;janeiro;14
LINHA 5;;;5;1;28/01/2025;janeiro;6
LINHA 3;;;67;63;28/01/2025;janeiro;130
LINHA 3;;;47;30;28/01/2025;janeiro;77
LINHA 6;;;18;47;28/01/2025;janeiro;65
LINHA 6;;;43;72;28/01/2025;janeiro;115
LINHA 6;;;24;21;28/01/2025;janeiro;45
LINHA 4;;;10;13;28/01/2025;janeiro;23
LINHA 4;;;15;6;28/01/2025;janeiro;21
LINHA 2;;;14;8;28/01/2025;janeiro;22
LINHA 2;;;21;13;28/01/2025;janeiro;34
LINHA 1;;;78;126;28/01/2025;janeiro;204
LINHA 1;;;81;83;28/01/2025;janeiro;164
LINHA 7;;;0;5;28/01/2025;janeiro;5
LINHA 7;;;4;1;28/01/2025;janeiro;5
LINHA 7;;;0;0;28/01/2025;janeiro;0
LINHA 5;;;8;16;29/01/2025;janeiro;24
LINHA 5;;;5;7;29/01/2025;janeiro;12
LINHA 5;;;3;2;29/01/2025;janeiro;5
LINHA 3;;;54;61;29/01/2025;janeiro;115
LINHA 3;;;39;21;29/01/2025;janeiro;60
LINHA 6;;;17;60;29/01/2025;janeiro;77
LINHA 6;;;38;72;29/01/2025;janeiro;110
LINHA 6;;;29;15;29/01/2025;janeiro;44
LINHA 4;;;7;9;29/01/2025;janeiro;16
LINHA 4;;;8;2;29/01/2025;janeiro;10
LINHA 2;;;5;3;29/01/2025;janeiro;8
LINHA 2;;;13;20;29/01/2025;janeiro;33
LINHA 2;;;8;5;29/01/2025;janeiro;13
LINHA 1;;;93;115;29/01/2025;janeiro;208
LINHA 1;;;71;63;29/01/2025;janeiro;134
LINHA 7;;;3;2;29/01/2025;janeiro;5
LINHA 7;;;1;2;29/01/2025;janeiro;3
LINHA 7;;;0;0;29/01/2025;janeiro;0
LINHA 5;;;12;19;30/01/2025;janeiro;31
LINHA 5;;;10;6;30/01/2025;janeiro;16
LINHA 3;;;66;72;30/01/2025;janeiro;138
LINHA 3;;;35;32;30/01/2025;janeiro;67
LINHA 6;;;59;132;30/01/2025;janeiro;191
LINHA 6;;;46;61;30/01/2025;janeiro;107
LINHA 4;;;8;5;30/01/2025;janeiro;13
LINHA 4;;;10;8;30/01/2025;janeiro;18
LINHA 2;;;15;25;30/01/2025;janeiro;40
LINHA 2;;;22;17;30/01/2025;janeiro;39
LINHA 1;;;91;118;30/01/2025;janeiro;209
LINHA 1;;;65;89;30/01/2025;janeiro;154
LINHA 7;;;2;13;30/01/2025;janeiro;15
LINHA 7;;;0;4;30/01/2025;janeiro;4
LINHA 7;;;2;3;30/01/2025;janeiro;5
LINHA 5;;;11;28;31/01/2025;janeiro;39
LINHA 5;;;0;2;31/01/2025;janeiro;2
LINHA 5;;;5;5;31/01/2025;janeiro;10
LINHA 3;;;54;52;31/01/2025;janeiro;106
LINHA 3;;;29;25;31/01/2025;janeiro;54
LINHA 6;;;23;44;31/01/2025;janeiro;67
LINHA 6;;;35;44;31/01/2025;janeiro;79
LINHA 6;;;20;24;31/01/2025;janeiro;44
LINHA 4;;;10;11;31/01/2025;janeiro;21
LINHA 4;;;11;3;31/01/2025;janeiro;14
LINHA 2;;;3;4;31/01/2025;janeiro;7
LINHA 2;;;12;15;31/01/2025;janeiro;27
LINHA 2;;;15;14;31/01/2025;janeiro;29
LINHA 1;;;58;124;31/01/2025;janeiro;182
LINHA 1;;;80;81;31/01/2025;janeiro;161
LINHA 7;;;0;5;31/01/2025;janeiro;5
LINHA 7;;;1;4;31/01/2025;janeiro;5
LINHA 7;;;0;1;31/01/2025;janeiro;1
LINHA 1;22;198;72;126;07/02/2025;fevereiro;198
LINHA 1;22;233;110;123;07/02/2025;fevereiro;233
LINHA 4;16;24;9;15;04/02/2025;fevereiro;24
LINHA 4;16;24;16;8;04/02/2025;fevereiro;24
